FIPSCode,QA3a,QA3b,Registration,,,
0100100000,33203,603,33806,,,
0100300000,110024,13453,123477,,,
0100500000,15344,883,16227,,,
0100700000,11769,303,12072,,,
0100900000,33534,357,33891,,,
0101100000,7041,195,7236,,,
0101300000,12281,944,13225,,,
0101500000,66687,378,67065,,,
0101700000,20895,848,21743,,,
0101900000,14553,269,14822,,,
0102100000,25870,471,26341,,,
0102300000,9395,1356,10751,,,
0102500000,18447,413,18860,,,
0102700000,8498,1230,9728,,,
0102900000,8884,909,9793,,,
0103100000,28824,527,29351,,,
0103300000,33943,435,34378,,,
0103500000,9887,255,10142,,,
0103700000,7512,335,7847,,,
0103900000,22158,97,22255,,,
0104100000,9474,107,9581,,,
0104300000,48160,2036,50196,,,
0104500000,27693,351,28044,,,
0104700000,29295,1810,31105,,,
0104900000,33946,2712,36658,,,
0105100000,46357,749,47106,,,
0105300000,21112,732,21844,,,
0105500000,59366,2460,61826,,,
0105700000,11301,150,11451,,,
0105900000,16902,239,17141,,,
0106100000,16000,218,16218,,,
0106300000,7298,69,7367,,,
0106500000,11940,157,12097,,,
0106700000,11842,88,11930,,,
0106900000,57832,2710,60542,,,
0107100000,34462,247,34709,,,
0107300000,407796,3292,411088,,,
0107500000,10367,152,10519,,,
0107700000,53328,234,53562,,,
0107900000,21854,234,22088,,,
0108100000,85765,657,86422,,,
0108300000,47742,2017,49759,,,
0108500000,9661,637,10298,,,
0108700000,17354,338,17692,,,
0108900000,206561,24884,231445,,,
0109100000,15339,801,16140,,,
0109300000,18304,386,18690,,,
0109500000,48523,496,49019,,,
0109700000,255328,2558,257886,,,
0109900000,15304,198,15502,,,
0110100000,139508,1581,141089,,,
0110300000,65721,2088,67809,,,
0110500000,8044,549,8593,,,
0110700000,12907,398,13305,,,
0110900000,19500,1691,21191,,,
0111100000,15197,271,15468,,,
0111300000,29460,1577,31037,,,
0111500000,50897,827,51724,,,
0111700000,115412,7204,122616,,,
0111900000,8534,1510,10044,,,
0112100000,43502,4795,48297,,,
0112300000,26171,1860,28031,,,
0112500000,107224,8526,115750,,,
0112700000,42178,405,42583,,,
0112900000,11475,1900,13375,,,
0113100000,8783,358,9141,,,
0113300000,13888,1906,15794,,,
0200000000,509011,65430,574441,,,
0400100000,46181,5353,51534,,,
0400300000,68612,10399,79011,,,
0400500000,70719,14794,85513,,,
0400700000,29472,4131,33603,,,
0400900000,17541,2919,20460,,,
0401100000,4382,428,4810,,,
0401200000,9061,2035,11096,,,
0401300000,1935729,328948,2264677,,,
0401500000,117535,19312,136847,,,
0401700000,56725,9367,66092,,,
0401900000,498657,87034,585691,,,
0402100000,158340,36992,195332,,,
0402300000,22669,3349,26018,,,
0402500000,123301,26003,149304,,,
0402700000,76977,15821,92798,,,
0500100000,8691,1534,10225,,,
0500300000,10234,1725,11959,,,
0500500000,24586,4031,28617,,,
0500700000,113221,16291,129512,,,
0500900000,19427,2835,22262,,,
0501100000,4704,691,5395,,,
0501300000,3212,322,3534,,,
0501500000,13219,1664,14883,,,
0501700000,5771,905,6676,,,
0501900000,10707,1958,12665,,,
0502100000,7054,1391,8445,,,
0502300000,15364,2432,17796,,,
0502500000,4362,548,4910,,,
0502700000,12700,1555,14255,,,
0502900000,9752,1375,11127,,,
0503100000,44840,9651,54491,,,
0503300000,27478,3021,30499,,,
0503500000,24845,4884,29729,,,
0503700000,9163,1462,10625,,,
0503900000,3786,951,4737,,,
0504100000,5954,1755,7709,,,
0504300000,9010,1483,10493,,,
0504500000,57515,11751,69266,,,
0504700000,8561,1435,9996,,,
0504900000,6134,1124,7258,,,
0505100000,54512,9948,64460,,,
0505300000,9742,294,10036,,,
0505500000,17242,2931,20173,,,
0505700000,9334,2018,11352,,,
0505900000,15526,3609,19135,,,
0506100000,6105,998,7103,,,
0506300000,17197,2902,20099,,,
0506500000,6701,824,7525,,,
0506700000,7412,2631,10043,,,
0506900000,38383,5747,44130,,,
0507100000,12080,1223,13303,,,
0507300000,3836,220,4056,,,
0507500000,7328,1304,8632,,,
0507700000,4358,862,5220,,,
0507900000,5336,846,6182,,,
0508100000,6584,611,7195,,,
0508300000,10125,1610,11735,,,
0508500000,33665,5899,39564,,,
0508700000,8403,948,9351,,,
0508900000,8620,1213,9833,,,
0509100000,21526,2945,24471,,,
0509300000,17923,3530,21453,,,
0509500000,4091,573,4664,,,
0509700000,4343,994,5337,,,
0509900000,5328,346,5674,,,
0510100000,5050,955,6005,,,
0510300000,13150,3875,17025,,,
0510500000,5252,1088,6340,,,
0510700000,12730,1527,14257,,,
0510900000,4829,689,5518,,,
0511100000,10907,1688,12595,,,
0511300000,10140,1488,11628,,,
0511500000,28381,3955,32336,,,
0511700000,4121,497,4618,,,
0511900000,211070,32915,243985,,,
0512100000,8440,1780,10220,,,
0512300000,11160,2700,13860,,,
0512500000,62189,7502,69691,,,
0512700000,4575,938,5513,,,
0512900000,5224,264,5488,,,
0513100000,58538,15845,74383,,,
0513300000,5596,1025,6621,,,
0513500000,9361,1971,11332,,,
0513700000,6648,1157,7805,,,
0513900000,22707,3482,26189,,,
0514100000,8237,1370,9607,,,
0514300000,101295,15113,116408,,,
0514500000,35663,5987,41650,,,
0514700000,3601,794,4395,,,
0514900000,8631,1318,9949,,,
0600100000,814009,528182,1342191,,,
0600300000,761,94,855,,,
0600500000,20817,3167,23984,,,
0600700000,117503,33438,150941,,,
0600900000,27058,0,27058,,,
0601100000,7595,26,7621,,,
0601300000,528403,77817,606220,,,
0601500000,12694,1694,14388,,,
0601700000,106931,10147,117078,,,
0601900000,416433,49203,465636,,,
0602100000,12034,4569,16603,,,
0602300000,76071,12007,88078,,,
0602500000,59149,47182,106331,,,
0602700000,9500,,9500,,,
0602900000,332228,34557,366785,,,
0603100000,48557,30699,79256,,,
0603300000,33489,,33489,,,
0603500000,12887,2589,15476,,,
0603700000,4870720,,4870720,,,
0603900000,52494,,52494,,,
0604100000,149039,,149039,,,
0604300000,10495,1919,12414,,,
0604500000,47502,,47502,,,
0604700000,95533,17666,113199,,,
0604900000,7044,4843,11887,,,
0605100000,5812,,5812,,,
0605300000,165731,,165731,,,
0605500000,70491,12585,83076,,,
0605700000,61690,,61690,,,
0605900000,1425216,321448,1746664,,,
0606100000,200402,,200402,,,
0606300000,11833,,11833,,,
0606500000,891575,242191,1133766,,,
0606700000,684088,178413,862501,,,
0606900000,24250,,24250,,,
0607100000,851684,720881,1572565,,,
0607300000,1546924,1872961,3419885,,,
0607500000,436184,236509,672693,,,
0607700000,297425,74974,372399,,,
0607900000,150303,,150303,,,
0608100000,355598,,355598,,,
0608300000,197120,54264,251384,,,
0608500000,805806,312019,1117825,,,
0608700000,142377,63365,205742,,,
0608900000,97936,20641,118577,,,
0609100000,2232,218,2450,,,
0609300000,24844,26968,51812,,,
0609500000,200740,,200740,,,
0609700000,244572,58773,303345,,,
0609900000,214188,105337,319525,,,
0610100000,41607,,41607,,,
0610300000,30169,3705,33874,,,
0610500000,7211,,7211,,,
0610700000,137659,51319,188978,,,
0610900000,29274,,29274,,,
0611100000,433471,89812,523283,,,
0611300000,101032,,101032,,,
0611500000,26923,18648,45571,,,
0800100000,204692,56656,261348,,,
0800300000,7292,1755,9047,,,
0800500000,317785,70199,387984,,,
0800700000,7608,2236,9844,,,
0800900000,2422,362,2784,,,
0801100000,2197,523,2720,,,
0801300000,186361,66158,252519,,,
0801400000,36103,7709,43812,,,
0801500000,11375,2113,13488,,,
0801700000,1288,136,1424,,,
0801900000,6361,1346,7707,,,
0802100000,4731,875,5606,,,
0802300000,2354,403,2757,,,
0802500000,1741,311,2052,,,
0802700000,3029,471,3500,,,
0802900000,17362,3717,21079,,,
0803100000,347201,128793,475994,,,
0803300000,1372,260,1632,,,
0803500000,185389,40418,225807,,,
0803700000,25743,7393,33136,,,
0803900000,15848,2936,18784,,,
0804100000,331433,93174,424607,,,
0804300000,23907,4463,28370,,,
0804500000,28432,4903,33335,,,
0804700000,4103,569,4672,,,
0804900000,9389,2190,11579,,,
0805100000,9360,2994,12354,,,
0805300000,637,106,743,,,
0805500000,4179,857,5036,,,
0805700000,973,177,1150,,,
0805900000,344078,79425,423503,,,
0806100000,946,89,1035,,,
0806300000,4097,1010,5107,,,
0806500000,3707,1357,5064,,,
0806700000,32155,10578,42733,,,
0806900000,198797,37116,235913,,,
0807100000,7736,2448,10184,,,
0807300000,2544,509,3053,,,
0807500000,10396,2039,12435,,,
0807700000,82666,26372,109038,,,
0807900000,710,99,809,,,
0808100000,6639,2831,9470,,,
0808300000,14538,4143,18681,,,
0808500000,22125,4115,26240,,,
0808700000,12649,2447,15096,,,
0808900000,9680,1487,11167,,,
0809100000,3419,868,4287,,,
0809300000,10658,2358,13016,,,
0809500000,2554,718,3272,,,
0809700000,11442,4054,15496,,,
0809900000,5660,1188,6848,,,
0810100000,88738,19896,108634,,,
0810300000,3608,819,4427,,,
0810500000,6292,1444,7736,,,
0810700000,14812,3789,18601,,,
0810900000,3574,715,4289,,,
0811100000,582,131,713,,,
0811300000,4720,1825,6545,,,
0811500000,1502,182,1684,,,
0811700000,17272,8548,25820,,,
0811900000,15494,2198,17692,,,
0812100000,2830,451,3281,,,
0812300000,136438,29709,166147,,,
0812500000,5309,910,6219,,,
0900104720,11364,451,11815,,,
0900108070,58242,16586,74828,,,
0900108980,9845,1285,11130,,,
0900118500,34735,1519,36254,,,
0900118850,12301,943,13244,,,
0900123890,5152,242,5394,,,
0900126620,36858,2412,39270,,,
0900133620,32493,5291,37784,,,
0900148620,11720,1464,13184,,,
0900150580,12831,789,13620,,,
0900150860,9483,27,9510,,,
0900152980,17163,711,17874,,,
0900156060,44212,2756,46968,,,
0900163480,6962,117,7079,,,
0900163970,16480,1075,17555,,,
0900168170,23112,915,24027,,,
0900168310,2611,138,2749,,,
0900173070,58787,3661,62448,,,
0900174190,31628,915,32543,,,
0900177200,23995,825,24820,,,
0900183430,6083,764,6847,,,
0900183500,16271,2199,18470,,,
0900186370,11468,508,11976,,,
0900302060,11621,1240,12861,,,
0900304300,12850,857,13707,,,
0900305910,12656,2638,15294,,,
0900308490,31631,3756,35387,,,
0900310100,6125,70,6195,,,
0900312270,7037,288,7325,,,
0900322070,3514,109,3623,,,
0900322630,25714,2332,28046,,,
0900324800,7194,237,7431,,,
0900325990,21713,4795,26508,,,
0900327600,17241,913,18154,,,
0900331240,21021,2010,23031,,,
0900332640,7044,583,7627,,,
0900337070,48913,9324,58237,,,
0900337140,1529,45,1574,,,
0900344700,26749,5835,32584,,,
0900345820,4033,216,4249,,,
0900350440,25792,9350,35142,,,
0900352140,17440,1870,19310,,,
0900360120,10564,86,10650,,,
0900365370,10943,1008,11951,,,
0900368940,16151,617,16768,,,
0900370550,25711,3346,29057,,,
0900371390,15524,934,16458,,,
0900374540,8295,544,8839,,,
0900382590,38899,1536,40435,,,
0900384900,16170,1471,17641,,,
0900387000,20041,853,20894,,,
0900387070,7285,762,8047,,,
0900502760,2584,94,2678,,,
0900504930,2487,347,2834,,,
0900508210,1273,7,1280,,,
0900510940,770,16,786,,,
0900516050,1088,21,1109,,,
0900517240,986,62,1048,,,
0900532290,2045,43,2088,,,
0900537280,4052,143,4195,,,
0900540290,1898,110,2008,,,
0900543370,5218,1069,6287,,,
0900549460,1682,61,1743,,,
0900551350,4386,315,4701,,,
0900552630,16336,932,17268,,,
0900553470,1049,120,1169,,,
0900554030,2008,0,2008,,,
0900560750,7420,472,7892,,,
0900565930,1689,20,1709,,,
0900566420,2888,263,3151,,,
0900567960,1613,203,1816,,,
0900575730,4357,709,5066,,,
0900576570,18939,924,19863,,,
0900579510,983,8,991,,,
0900579720,2414,51,2465,,,
0900580490,14563,422,14985,,,
0900586440,6794,232,7026,,,
0900587910,6751,291,7042,,,
0900714300,2458,161,2619,,,
0900715350,9239,201,9440,,,
0900718080,9281,347,9628,,,
0900719130,3159,115,3274,,,
0900720810,5045,170,5215,,,
0900722280,5872,147,6019,,,
0900722490,7748,824,8572,,,
0900726270,4685,156,4841,,,
0900735230,5723,303,6026,,,
0900740710,4297,287,4584,,,
0900747080,3141,110,3251,,,
0900747360,22362,3853,26215,,,
0900757320,7544,389,7933,,,
0900761800,5535,659,6194,,,
0900781680,4224,181,4405,,,
0900901220,9359,877,10236,,,
0900903250,3899,191,4090,,,
0900904580,3882,184,4066,,,
0900907310,18074,1150,19224,,,
0900914160,17135,2136,19271,,,
0900919550,5448,1239,6687,,,
0900922910,15025,1370,16395,,,
0900934950,14076,1938,16014,,,
0900935650,33056,1432,34488,,,
0900944560,13191,766,13957,,,
0900946520,28794,4673,33467,,,
0900946940,5200,92,5292,,,
0900947535,33062,1183,34245,,,
0900949950,16913,996,17909,,,
0900952070,70814,7455,78269,,,
0900953890,8939,100,9039,,,
0900954870,15250,511,15761,,,
0900957600,10332,98,10430,,,
0900958300,8585,287,8872,,,
0900962290,6111,372,6483,,,
0900967610,9468,411,9879,,,
0900969640,13528,1545,15073,,,
0900978740,25101,1331,26432,,,
0900980070,56389,2360,58749,,,
0900982870,24832,5546,30378,,,
0900987560,11007,290,11297,,,
0900987700,6515,284,6799,,,
0901106820,1693,100,1793,,,
0901115910,10178,324,10502,,,
0901123400,10852,1613,12465,,,
0901129910,1196,85,1281,,,
0901133900,6603,345,6948,,,
0901134250,17964,3054,21018,,,
0901142390,4325,522,4847,,,
0901142600,8384,1076,9460,,,
0901143230,2593,114,2707,,,
0901144210,1788,68,1856,,,
0901148900,8492,1599,10091,,,
0901152350,14391,566,14957,,,
0901155500,3809,7,3816,,,
0901156270,15456,5827,21283,,,
0901157040,5132,1062,6194,,,
0901162150,2995,354,3349,,,
0901166210,2440,439,2879,,,
0901171670,1667,221,1888,,,
0901173770,12476,582,13058,,,
0901178600,1361,329,1690,,,
0901180280,12558,444,13002,,,
0901301080,2072,39,2111,,,
0901306260,3215,314,3529,,,
0901316400,3608,68,3676,,,
0901317800,7338,618,7956,,,
0901325360,9375,632,10007,,,
0901337910,6460,89,6549,,,
0901344910,11665,3668,15333,,,
0901369220,5590,866,6456,,,
0901372090,7480,218,7698,,,
0901376290,9311,1048,10359,,,
0901377830,600,16,616,,,
0901378250,14054,2788,16842,,,
0901385950,3190,519,3709,,,
0901501430,2664,241,2905,,,
0901509190,4830,202,5032,,,
0901512130,3295,160,3455,,,
0901513810,1315,32,1347,,,
0901521860,1162,29,1191,,,
0901536000,1191,150,1341,,,
0901540500,9327,269,9596,,,
0901559980,8657,209,8866,,,
0901561030,2478,259,2737,,,
0901562710,5185,175,5360,,,
0901567400,1120,0,1120,,,
0901573420,2206,41,2247,,,
0901575870,5305,210,5515,,,
0901586790,10414,3931,14345,,,
0901588190,4867,490,5357,,,
1000100000,103811,7581,111392,,,
1000300000,359394,29529,388923,,,
1000500000,133079,8628,141707,,,
1100100000,456633,,456633,,,
1200100000,156224,15913,172137,,,
1200300000,14044,437,14481,,,
1200500000,110823,14693,125516,,,
1200700000,15644,839,16483,,,
1200900000,377819,30091,407910,,,
1201100000,1071305,127311,1198616,,,
1201300000,8278,157,8435,,,
1201500000,119484,4206,123690,,,
1201700000,97139,5837,102976,,,
1201900000,133930,6138,140068,,,
1202100000,185662,16043,201705,,,
1202300000,35577,2384,37961,,,
1202700000,14922,1511,16433,,,
1202900000,9900,489,10389,,,
1203100000,550495,36530,587025,,,
1203300000,200836,7987,208823,,,
1203500000,71581,7404,78985,,,
1203700000,7217,658,7875,,,
1203900000,28911,1320,30231,,,
1204100000,11076,15,11091,,,
1204300000,5992,867,6859,,,
1204500000,9409,101,9510,,,
1204700000,7719,331,8050,,,
1204900000,10960,1641,12601,,,
1205100000,16626,1435,18061,,,
1205300000,125064,5326,130390,,,
1205500000,60501,3705,64206,,,
1205700000,766186,35694,801880,,,
1205900000,11044,459,11503,,,
1206100000,96754,1897,98651,,,
1206300000,27530,1902,29432,,,
1206500000,9357,230,9587,,,
1206700000,4424,104,4528,,,
1206900000,207520,9025,216545,,,
1207100000,404181,22161,426342,,,
1207300000,191701,9482,201183,,,
1207500000,25717,434,26151,,,
1207700000,4478,68,4546,,,
1207900000,11507,611,12118,,,
1208100000,205406,19456,224862,,,
1208300000,215596,17572,233168,,,
1208500000,105273,3995,109268,,,
1208600000,1279680,87485,1367165,,,
1208700000,51506,4767,56273,,,
1208900000,55440,1223,56663,,,
1209100000,123642,16602,140244,,,
1209300000,19416,372,19788,,,
1209500000,715743,42391,758134,,,
1209700000,167286,25854,193140,,,
1209900000,850638,62067,912705,,,
1210100000,303010,20406,323416,,,
1210300000,624092,35252,659344,,,
1210500000,356132,17990,374122,,,
1210700000,45126,489,45615,,,
1210900000,160075,8324,168399,,,
1211100000,174126,15123,189249,,,
1211300000,124261,1894,126155,,,
1211500000,276554,13999,290553,,,
1211700000,266618,14132,280750,,,
1211900000,82173,2123,84296,,,
1212100000,24965,1336,26301,,,
1212300000,12074,598,12672,,,
1212500000,7140,70,7210,,,
1212700000,330831,28943,359774,,,
1212900000,18751,703,19454,,,
1213100000,41710,672,42382,,,
1213300000,14423,583,15006,,,
1300100000,9313,1334,10647,,,
1300300000,3796,470,4266,,,
1300500000,5033,785,5818,,,
1300700000,2047,66,2113,,,
1300900000,20587,2958,23545,,,
1301100000,8253,1302,9555,,,
1301300000,33760,6617,40377,,,
1301500000,49497,9497,58994,,,
1301700000,7762,1416,9178,,,
1301900000,8279,1906,10185,,,
1302100000,83428,10428,93856,,,
1302300000,5982,705,6687,,,
1302500000,8154,1523,9677,,,
1302700000,8796,1038,9834,,,
1302900000,18974,3469,22443,,,
1303100000,32641,6582,39223,,,
1303300000,12516,1779,14295,,,
1303500000,12061,1482,13543,,,
1303700000,2748,229,2977,,,
1303900000,25170,6047,31217,,,
1304300000,4496,861,5357,,,
1304500000,55554,9371,64925,,,
1304700000,31584,8322,39906,,,
1304900000,5277,550,5827,,,
1305100000,136788,36577,173365,,,
1305300000,2656,1175,3831,,,
1305500000,10866,2106,12972,,,
1305700000,129069,16620,145689,,,
1305900000,56318,10807,67125,,,
1306100000,1733,101,1834,,,
1306300000,128772,25673,154445,,,
1306500000,3538,526,4064,,,
1306700000,401691,58384,460075,,,
1306900000,18799,3315,22114,,,
1307100000,18156,3742,21898,,,
1307300000,76034,14730,90764,,,
1307500000,7766,1253,9019,,,
1307700000,73243,11579,84822,,,
1307900000,6470,982,7452,,,
1308100000,10220,1826,12046,,,
1308300000,8155,1902,10057,,,
1308500000,13289,1421,14710,,,
1308700000,13447,2566,16013,,,
1308900000,403266,65226,468492,,,
1309100000,9396,1458,10854,,,
1309300000,5359,664,6023,,,
1309500000,50433,8065,58498,,,
1309700000,71657,11129,82786,,,
1309900000,6582,840,7422,,,
1310100000,1564,225,1789,,,
1310300000,28269,5486,33755,,,
1310500000,10411,1460,11871,,,
1310700000,10149,1828,11977,,,
1310900000,4562,758,5320,,,
1311100000,13934,2277,16211,,,
1311300000,69485,11378,80863,,,
1311500000,44563,7320,51883,,,
1311700000,108465,12515,120980,,,
1311900000,10586,1474,12060,,,
1312100000,562809,94060,656869,,,
1312300000,14807,2449,17256,,,
1312500000,1642,138,1780,,,
1312700000,45074,7810,52884,,,
1312900000,23673,4560,28233,,,
1313100000,12229,2193,14422,,,
1313300000,10446,1154,11600,,,
1313500000,395291,68390,463681,,,
1313700000,19302,2947,22249,,,
1313900000,81373,15299,96672,,,
1314100000,5306,573,5879,,,
1314300000,13915,2314,16229,,,
1314500000,19455,2858,22313,,,
1314700000,12343,2022,14365,,,
1314900000,5141,1440,6581,,,
1315100000,119728,17604,137332,,,
1315300000,74656,15272,89928,,,
1315500000,4693,479,5172,,,
1315700000,31214,4119,35333,,,
1315900000,7469,1104,8573,,,
1316100000,6880,1096,7976,,,
1316300000,9296,1230,10526,,,
1316500000,4451,610,5061,,,
1316700000,4704,495,5199,,,
1316900000,15046,2113,17159,,,
1317100000,9674,1509,11183,,,
1317300000,4142,594,4736,,,
1317500000,24257,2217,26474,,,
1317700000,18053,2355,20408,,,
1317900000,25242,5747,30989,,,
1318100000,5149,570,5719,,,
1318300000,5900,1377,7277,,,
1318500000,46927,14799,61726,,,
1318700000,14870,1984,16854,,,
1318900000,5898,1025,6923,,,
1319100000,14295,2058,16353,,,
1319300000,4244,484,4728,,,
1319500000,12080,2061,14141,,,
1319700000,8303,535,8838,,,
1319900000,12161,1872,14033,,,
1320100000,3600,381,3981,,,
1320500000,10861,1702,12563,,,
1320700000,15439,1825,17264,,,
1320900000,4675,444,5119,,,
1321100000,10860,1409,12269,,,
1321300000,16103,3154,19257,,,
1321500000,100207,19817,120024,,,
1321700000,56161,8733,64894,,,
1321900000,22515,2265,24780,,,
1322100000,7602,1147,8749,,,
1322300000,74341,12449,86790,,,
1322500000,14488,2512,17000,,,
1322700000,16590,2377,18967,,,
1322900000,9297,1216,10513,,,
1323100000,10149,1248,11397,,,
1323300000,17958,3071,21029,,,
1323500000,4943,473,5416,,,
1323700000,11477,1481,12958,,,
1323900000,1380,114,1494,,,
1324100000,9414,1257,10671,,,
1324300000,3901,305,4206,,,
1324500000,101290,24734,126024,,,
1324700000,48666,8085,56751,,,
1324900000,2231,343,2574,,,
1325100000,7695,1385,9080,,,
1325300000,4890,893,5783,,,
1325500000,34153,5220,39373,,,
1325700000,12893,2404,15297,,,
1325900000,2864,165,3029,,,
1326100000,15215,2286,17501,,,
1326300000,4182,398,4580,,,
1326500000,1199,77,1276,,,
1326700000,9097,1262,10359,,,
1326900000,4272,547,4819,,,
1327100000,5267,897,6164,,,
1327300000,5790,675,6465,,,
1327500000,24409,4151,28560,,,
1327700000,19480,2631,22111,,,
1327900000,11737,2604,14341,,,
1328100000,8075,521,8596,,,
1328300000,3714,347,4061,,,
1328500000,34454,6509,40963,,,
1328700000,4680,631,5311,,,
1328900000,5382,793,6175,,,
1329100000,13566,1789,15355,,,
1329300000,13865,2017,15882,,,
1329500000,30488,7514,38002,,,
1329700000,48220,7499,55719,,,
1329900000,15779,2786,18565,,,
1330100000,3144,400,3544,,,
1330300000,10939,1400,12339,,,
1330500000,13607,2365,15972,,,
1330700000,1435,98,1533,,,
1330900000,2864,360,3224,,,
1331100000,13817,2074,15891,,,
1331300000,37603,7080,44683,,,
1331500000,3892,576,4468,,,
1331700000,5845,559,6404,,,
1331900000,5360,648,6008,,,
1332100000,10815,1587,12402,,,
1500100000,93269,11926,105195,,,
1500300000,423660,50670,474330,,,
1500500000,,,0.00%,,,
1500700000,37362,4507,41869,,,
1500900000,76349,10978,87327,,,
1600100000,226636,,226636,,,
1600300000,2471,,2471,,,
1600500000,42233,,42233,,,
1600700000,3297,,3297,,,
1600900000,4881,,4881,,,
1601100000,20056,,20056,,,
1601300000,12138,,12138,,,
1601500000,4416,,4416,,,
1601700000,22629,,22629,,,
1601900000,49662,,49662,,,
1602100000,5755,,5755,,,
1602300000,1564,,1564,,,
1602500000,702,,702,,,
1602700000,81304,,81304,,,
1602900000,3656,,3656,,,
1603100000,9686,,9686,,,
1603300000,375,,375,,,
1603500000,4574,,4574,,,
1603700000,2865,,2865,,,
1603900000,9970,,9970,,,
1604100000,6150,,6150,,,
1604300000,6724,,6724,,,
1604500000,9194,,9194,,,
1604700000,6194,,6194,,,
1604900000,9534,,9534,,,
1605100000,12970,,12970,,,
1605300000,7765,,7765,,,
1605500000,71740,,71740,,,
1605700000,22212,,22212,,,
1605900000,4841,,4841,,,
1606100000,2015,,2015,,,
1606300000,2050,,2050,,,
1606500000,15969,,15969,,,
1606700000,7948,,7948,,,
1606900000,20463,,20463,,,
1607100000,2423,,2423,,,
1607300000,4755,,4755,,,
1607500000,10513,,10513,,,
1607700000,3339,,3339,,,
1607900000,6315,,6315,,,
1608100000,5833,,5833,,,
1608300000,34655,,34655,,,
1608500000,6123,,6123,,,
1608700000,5114,,5114,,,
1700100000,44280,5876,50156,,,
1700300000,5644,1839,7483,,,
1700500000,12289,0,12289,,,
1700700000,32036,2410,34446,,,
1700900000,3468,315,3783,,,
1701100000,24311,1761,26072,,,
1701300000,3695,121,3816,,,
1701500000,11393,55,11448,,,
1701700000,8747,627,9374,,,
1701900000,113122,,113122,,,
1702100000,22351,735,23086,,,
1702300000,11629,871,12500,,,
1702500000,8982,1157,10139,,,
1702700000,24679,2048,26727,,,
1702900000,30204,2028,32232,,,
1703012000,,,0.00%,,,
1703100000,1398724,193907,1592631,,,
1703300000,14612,2306,16918,,,
1703500000,7508,459,7967,,,
1703700000,58482,5431,63913,,,
1703900000,12151,383,12534,,,
1704100000,11693,586,12279,,,
1704300000,587586,44157,631743,,,
1704500000,12529,745,13274,,,
1704700000,4430,199,4629,,,
1704900000,22414,917,23331,,,
1705100000,15014,65,15079,,,
1705300000,8695,720,9415,,,
1705500000,28985,29327,58312,,,
1705700000,25257,346,25603,,,
1705900000,3791,151,3942,,,
1706100000,8865,273,9138,,,
1706300000,30095,5462,35557,,,
1706500000,5681,81,5762,,,
1706613000,46457,4212,50669,,,
1706700000,12024,758,12782,,,
1706900000,3096,843,3939,,,
1707100000,4904,3453,8357,,,
1707300000,33314,1654,34968,,,
1707500000,18481,832,19313,,,
1707700000,33443,6673,40116,,,
1707900000,6694,465,7159,,,
1708100000,23119,7580,30699,,,
1708300000,,,0.00%,,,
1708500000,15782,891,16673,,,
1708700000,8133,336,8469,,,
1708900000,227725,11033,238758,,,
1709100000,31292,9573,40865,,,
1709300000,65076,3812,68888,,,
1709500000,148,766,914,,,
1709700000,404004,38882,442886,,,
1709900000,67532,12308,79840,,,
1710100000,9221,1056,10277,,,
1710300000,21466,1946,23412,,,
1710500000,21296,2861,24157,,,
1710700000,19263,69,19332,,,
1710900000,16951,2180,19131,,,
1711100000,206197,11689,217886,,,
1711300000,57215,5524,62739,,,
1711500000,75200,3456,78656,,,
1711700000,31160,1432,32592,,,
1711900000,178844,13126,191970,,,
1712100000,24736,4607,29343,,,
1712300000,8245,244,8489,,,
1712500000,10030,256,10286,,,
1712700000,11304,3301,14605,,,
1712900000,8626,57,8683,,,
1713100000,12122,1464,13586,,,
1713300000,24374,818,25192,,,
1713500000,17221,1315,18536,,,
1713700000,22287,1142,23429,,,
1713900000,8715,555,9270,,,
1714000000,1368708,248730,1617438,,,
1714100000,33852,171,34023,,,
1714300000,45992,4457,50449,,,
1714500000,,,0.00%,,,
1714700000,12072,109,12181,,,
1714900000,11882,9,11891,,,
1715100000,2945,198,3143,,,
1715300000,4676,3320,7996,,,
1715500000,4241,13,4254,,,
1715700000,20792,0,20792,,,
1715900000,11074,1176,12250,,,
1716100000,93478,57286,150764,,,
1716300000,155699,19698,175397,,,
1716500000,15995,176,16171,,,
1716700000,136270,19001,155271,,,
1716900000,5469,14,5483,,,
1717100000,3742,326,4068,,,
1717300000,14509,1330,15839,,,
1717500000,,,0.00%,,,
1717700000,33639,2482,36121,,,
1717900000,85862,7054,92916,,,
1718100000,12139,6926,19065,,,
1718300000,30191,4764,34955,,,
1718500000,8715,772,9487,,,
1718563000,16933,2352,19285,,,
1718700000,11957,402,12359,,,
1718900000,9860,7157,17017,,,
1719100000,12124,505,12629,,,
1719300000,10743,957,11700,,,
1719500000,37510,3199,40709,,,
1719700000,388057,17974,406031,,,
1719900000,43318,5045,48363,,,
1720100000,89526,600,90126,,,
1720300000,22456,2695,25151,,,
1722255000,18641,2865,21506,,,
1728326000,17995,1454,19449,,,
1759000000,66262,12564,78826,,,
1765000000,76685,17805,94490,,,
1800100000,16922,1937,18859,,,
1800300000,216256,44744,261000,,,
1800500000,43428,9073,52501,,,
1800700000,5134,808,5942,,,
1800900000,7336,1359,8695,,,
1801100000,39776,5197,44973,,,
1801300000,10427,2102,12529,,,
1801500000,11652,2112,13764,,,
1801700000,19543,2304,21847,,,
1801900000,75635,13020,88655,,,
1802100000,16784,2480,19264,,,
1802300000,16401,3287,19688,,,
1802500000,7139,2136,9275,,,
1802700000,16163,2910,19073,,,
1802900000,33922,4842,38764,,,
1803100000,14510,1477,15987,,,
1803300000,25078,4134,29212,,,
1803500000,71407,16651,88058,,,
1803700000,27546,2220,29766,,,
1803900000,103258,24822,128080,,,
1804100000,14287,2944,17231,,,
1804300000,48806,8153,56959,,,
1804500000,9903,2551,12454,,,
1804700000,14951,3396,18347,,,
1804900000,11531,1384,12915,,,
1805100000,20235,3315,23550,,,
1805300000,40592,8678,49270,,,
1805500000,18690,2398,21088,,,
1805700000,186226,24836,211062,,,
1805900000,45067,6803,51870,,,
1806100000,24989,2464,27453,,,
1806300000,89957,10487,100444,,,
1806500000,27472,2669,30141,,,
1806700000,52668,9464,62132,,,
1806900000,21931,3132,25063,,,
1807100000,24976,4497,29473,,,
1807300000,20608,1988,22596,,,
1807500000,11148,1102,12250,,,
1807700000,18808,2174,20982,,,
1807900000,16024,2452,18476,,,
1808100000,85064,14151,99215,,,
1808300000,21622,4758,26380,,,
1808500000,43937,7063,51000,,,
1808700000,13572,2402,15974,,,
1808900000,304108,47679,351787,,,
1809100000,66904,13851,80755,,,
1809300000,26718,5024,31742,,,
1809500000,81069,13414,94483,,,
1809700000,530449,121556,652005,,,
1809900000,25313,4184,29497,,,
1810100000,7279,577,7856,,,
1810300000,19531,3400,22931,,,
1810500000,72165,33150,105315,,,
1810700000,19936,2975,22911,,,
1810900000,40820,7567,48387,,,
1811100000,9368,1852,11220,,,
1811300000,25875,4055,29930,,,
1811500000,4347,449,4796,,,
1811700000,12243,3223,15466,,,
1811900000,11831,2902,14733,,,
1812100000,9519,2761,12280,,,
1812300000,11179,1240,12419,,,
1812500000,8301,1113,9414,,,
1812700000,103877,14316,118193,,,
1812900000,16955,1952,18907,,,
1813100000,8217,1189,9406,,,
1813300000,20557,3423,23980,,,
1813500000,14875,2467,17342,,,
1813700000,18879,2468,21347,,,
1813900000,9829,1774,11603,,,
1814100000,163373,36646,200019,,,
1814300000,14969,4510,19479,,,
1814500000,24650,3585,28235,,,
1814700000,13601,2118,15719,,,
1814900000,14961,2635,17596,,,
1815100000,19352,2224,21576,,,
1815300000,12750,1922,14672,,,
1815500000,5809,1346,7155,,,
1815700000,86111,15242,101353,,,
1815900000,10197,2380,12577,,,
1816100000,4687,1082,5769,,,
1816300000,105837,36887,142724,,,
1816500000,8066,1646,9712,,,
1816700000,64583,12194,76777,,,
1816900000,18532,3749,22281,,,
1817100000,5695,468,6163,,,
1817300000,38523,8224,46747,,,
1817500000,16637,2764,19401,,,
1817700000,34999,6186,41185,,,
1817900000,16772,1764,18536,,,
1818100000,14117,2645,16762,,,
1818300000,20073,1548,21621,,,
1900100000,5030,497,5527,,,
1900300000,2784,264,3048,,,
1900500000,9575,560,10135,,,
1900700000,8320,926,9246,,,
1900900000,4223,328,4551,,,
1901100000,16969,1143,18112,,,
1901300000,82240,7493,89733,,,
1901500000,17800,1217,19017,,,
1901700000,16187,1445,17632,,,
1901900000,13286,916,14202,,,
1902100000,11690,735,12425,,,
1902300000,9711,525,10236,,,
1902500000,6350,696,7046,,,
1902700000,14104,1052,15156,,,
1902900000,9329,962,10291,,,
1903100000,11456,817,12273,,,
1903300000,29798,2453,32251,,,
1903500000,8139,616,8755,,,
1903700000,8507,599,9106,,,
1903900000,5579,604,6183,,,
1904100000,11114,1069,12183,,,
1904300000,11405,915,12320,,,
1904500000,30705,3467,34172,,,
1904700000,9228,764,9992,,,
1904900000,46661,6341,53002,,,
1905100000,4834,432,5266,,,
1905300000,4694,1103,5797,,,
1905500000,11367,671,12038,,,
1905700000,25867,2451,28318,,,
1905900000,12087,636,12723,,,
1906100000,63083,5015,68098,,,
1906300000,6453,916,7369,,,
1906500000,11845,619,12464,,,
1906700000,10546,587,11133,,,
1906900000,6686,457,7143,,,
1907100000,4788,890,5678,,,
1907300000,6285,520,6805,,,
1907500000,8509,461,8970,,,
1907700000,7348,587,7935,,,
1907900000,9896,902,10798,,,
1908100000,7535,504,8039,,,
1908300000,11069,1135,12204,,,
1908500000,8013,100,8113,,,
1908700000,12903,1201,14104,,,
1908900000,5801,441,6242,,,
1909100000,6330,578,6908,,,
1909300000,4847,370,5217,,,
1909500000,11333,801,12134,,,
1909700000,13802,1176,14978,,,
1909900000,23588,3168,26756,,,
1910100000,10315,1427,11742,,,
1910300000,90030,21003,111033,,,
1910500000,12899,805,13704,,,
1910700000,6678,528,7206,,,
1910900000,10971,770,11741,,,
1911100000,21922,2016,23938,,,
1911300000,131486,22283,153769,,,
1911500000,6539,871,7410,,,
1911700000,5546,526,6072,,,
1911900000,7911,571,8482,,,
1912100000,10511,903,11414,,,
1912300000,13860,1553,15413,,,
1912500000,22119,2609,24728,,,
1912700000,23781,2403,26184,,,
1912900000,9796,954,10750,,,
1913100000,6960,401,7361,,,
1913300000,6187,491,6678,,,
1913500000,4741,309,5050,,,
1913700000,6839,844,7683,,,
1913900000,26203,3055,29258,,,
1914100000,9332,863,10195,,,
1914300000,4121,438,4559,,,
1914500000,9135,1315,10450,,,
1914700000,6019,627,6646,,,
1914900000,16391,1362,17753,,,
1915100000,5015,530,5545,,,
1915300000,269401,15610,285011,,,
1915500000,55791,6280,62071,,,
1915700000,12680,2008,14688,,,
1915900000,3081,121,3202,,,
1916100000,6916,700,7616,,,
1916300000,111983,15480,127463,,,
1916500000,7990,1115,9105,,,
1916700000,20146,1032,21178,,,
1916900000,54015,10958,64973,,,
1917100000,11217,985,12202,,,
1917300000,3810,478,4288,,,
1917500000,7627,394,8021,,,
1917700000,4698,434,5132,,,
1917900000,21112,1997,23109,,,
1918100000,31417,2402,33819,,,
1918300000,13812,970,14782,,,
1918500000,3471,331,3802,,,
1918700000,23399,2425,25824,,,
1918900000,7269,633,7902,,,
1919100000,13287,2031,15318,,,
1919300000,56336,5803,62139,,,
1919500000,5251,464,5715,,,
1919700000,7994,630,8624,,,
2000100000,7673,909,8582,,,
2000300000,4911,407,5318,,,
2000500000,9912,965,10877,,,
2000700000,2908,89,2997,,,
2000900000,15119,1927,17046,,,
2001100000,10410,850,11260,,,
2001300000,5482,385,5867,,,
2001500000,36848,3045,39893,,,
2001700000,1647,161,1808,,,
2001900000,2242,26,2268,,,
2002100000,15224,1228,16452,,,
2002300000,1836,29,1865,,,
2002500000,1416,45,1461,,,
2002700000,5268,381,5649,,,
2002900000,5675,376,6051,,,
2003100000,5767,230,5997,,,
2003300000,1107,20,1127,,,
2003500000,18032,1240,19272,,,
2003700000,22070,1440,23510,,,
2003900000,1859,159,2018,,,
2004100000,11875,875,12750,,,
2004300000,4522,309,4831,,,
2004500000,64639,11684,76323,,,
2004700000,1803,81,1884,,,
2004900000,1713,107,1820,,,
2005100000,15571,2306,17877,,,
2005300000,3747,332,4079,,,
2005500000,15274,1821,17095,,,
2005700000,14250,963,15213,,,
2005900000,16032,1284,17316,,,
2006100000,9802,4141,13943,,,
2006300000,1817,45,1862,,,
2006500000,1702,235,1937,,,
2006700000,3274,134,3408,,,
2006900000,2765,116,2881,,,
2007100000,839,92,931,,,
2007300000,4523,376,4899,,,
2007500000,1281,28,1309,,,
2007700000,3805,314,4119,,,
2007900000,19679,1145,20824,,,
2008100000,2153,208,2361,,,
2008300000,1312,90,1402,,,
2008500000,7780,1112,8892,,,
2008700000,12102,775,12877,,,
2008900000,1884,328,2212,,,
2009100000,334310,32210,366520,,,
2009300000,1984,113,2097,,,
2009500000,5084,257,5341,,,
2009700000,1433,141,1574,,,
2009900000,12560,3357,15917,,,
2010100000,1153,144,1297,,,
2010300000,37891,8956,46847,,,
2010500000,2077,114,2191,,,
2010700000,6528,640,7168,,,
2010900000,1742,26,1768,,,
2011100000,16970,2457,19427,,,
2011300000,15847,255,16102,,,
2011500000,6926,832,7758,,,
2011700000,6137,272,6409,,,
2011900000,2961,210,3171,,,
2012100000,20068,650,20718,,,
2012300000,4045,134,4179,,,
2012500000,18008,814,18822,,,
2012700000,3659,100,3759,,,
2012900000,1787,147,1934,,,
2013100000,6841,217,7058,,,
2013300000,10156,1050,11206,,,
2013500000,1960,59,2019,,,
2013700000,3156,134,3290,,,
2013900000,9707,714,10421,,,
2014100000,2559,202,2761,,,
2014300000,3926,427,4353,,,
2014500000,3569,375,3944,,,
2014700000,3624,109,3733,,,
2014900000,12397,1763,14160,,,
2015100000,4998,864,5862,,,
2015300000,2030,63,2093,,,
2015500000,35475,5546,41021,,,
2015700000,3681,57,3738,,,
2015900000,5650,239,5889,,,
2016100000,26014,7737,33751,,,
2016300000,3282,63,3345,,,
2016500000,2098,196,2294,,,
2016700000,4118,280,4398,,,
2016900000,32191,1296,33487,,,
2017100000,3026,151,3177,,,
2017300000,255587,14194,269781,,,
2017500000,8711,1214,9925,,,
2017700000,96306,9810,106116,,,
2017900000,1712,29,1741,,,
2018100000,3008,895,3903,,,
2018300000,2728,125,2853,,,
2018500000,2575,85,2660,,,
2018700000,1119,108,1227,,,
2018900000,2903,1,2904,,,
2019100000,14744,1200,15944,,,
2019300000,4655,165,4820,,,
2019500000,2084,136,2220,,,
2019700000,4451,130,4581,,,
2019900000,948,19,967,,,
2020100000,3128,520,3648,,,
2020300000,1390,6,1396,,,
2020500000,4992,12,5004,,,
2020700000,2088,122,2210,,,
2020900000,66020,4843,70863,,,
2100100000,13111,329,13440,,,
2100300000,13769,344,14113,,,
2100500000,16952,255,17207,,,
2100700000,6292,133,6425,,,
2100900000,29414,580,29994,,,
2101100000,9102,227,9329,,,
2101300000,20545,648,21193,,,
2101500000,91657,2398,94055,,,
2101700000,13857,300,14157,,,
2101900000,37372,1206,38578,,,
2102100000,20727,441,21168,,,
2102300000,6186,152,6338,,,
2102500000,11596,755,12351,,,
2102700000,14611,439,15050,,,
2102900000,55370,758,56128,,,
2103100000,9110,176,9286,,,
2103300000,10029,147,10176,,,
2103500000,27577,913,28490,,,
2103700000,66924,2080,69004,,,
2103900000,3963,116,4079,,,
2104100000,7720,260,7980,,,
2104300000,19408,714,20122,,,
2104500000,10799,255,11054,,,
2104700000,45782,2349,48131,,,
2104900000,26715,498,27213,,,
2105100000,14840,464,15304,,,
2105300000,7468,84,7552,,,
2105500000,6554,149,6703,,,
2105700000,5394,294,5688,,,
2105900000,69459,1478,70937,,,
2106100000,8838,201,9039,,,
2106300000,5089,144,5233,,,
2106500000,10448,238,10686,,,
2106700000,208882,3405,212287,,,
2106900000,10489,253,10742,,,
2107100000,30361,1448,31809,,,
2107300000,35422,1382,36804,,,
2107500000,5246,283,5529,,,
2107700000,6217,220,6437,,,
2107900000,12353,265,12618,,,
2108100000,16548,302,16850,,,
2108300000,24533,469,25002,,,
2108500000,17966,329,18295,,,
2108700000,8636,161,8797,,,
2108900000,28448,842,29290,,,
2109100000,6608,94,6702,,,
2109300000,73587,2093,75680,,,
2109500000,20421,949,21370,,,
2109700000,13075,205,13280,,,
2109900000,12961,384,13345,,,
2110100000,32891,1086,33977,,,
2110300000,11524,165,11689,,,
2110500000,3665,74,3739,,,
2110700000,32708,694,33402,,,
2110900000,9836,393,10229,,,
2111100000,548815,12466,561281,,,
2111300000,35866,1070,36936,,,
2111500000,17542,586,18128,,,
2111700000,119973,3339,123312,,,
2111900000,11681,279,11960,,,
2112100000,23615,874,24489,,,
2112300000,10120,191,10311,,,
2112500000,43932,1018,44950,,,
2112700000,12052,363,12415,,,
2112900000,5319,191,5510,,,
2113100000,8680,250,8930,,,
2113300000,16435,596,17031,,,
2113500000,10066,270,10336,,,
2113700000,17600,453,18053,,,
2113900000,7485,180,7665,,,
2114100000,17148,418,17566,,,
2114300000,6261,177,6438,,,
2114500000,50861,1466,52327,,,
2114700000,11134,573,11707,,,
2114900000,6876,134,7010,,,
2115100000,59007,1607,60614,,,
2115300000,10273,275,10548,,,
2115500000,12784,188,12972,,,
2115700000,24387,388,24775,,,
2115900000,8318,579,8897,,,
2116100000,12507,388,12895,,,
2116300000,19998,301,20299,,,
2116500000,5236,246,5482,,,
2116700000,16969,268,17237,,,
2116900000,7583,207,7790,,,
2117100000,8513,94,8607,,,
2117300000,19701,246,19947,,,
2117500000,9033,222,9255,,,
2117700000,22363,599,22962,,,
2117900000,31220,487,31707,,,
2118100000,5354,88,5442,,,
2118300000,16781,326,17107,,,
2118500000,46071,764,46835,,,
2118700000,7880,172,8052,,,
2118900000,3633,56,3689,,,
2119100000,10190,190,10380,,,
2119300000,20791,530,21321,,,
2119500000,48110,2123,50233,,,
2119700000,9672,327,9999,,,
2119900000,45633,992,46625,,,
2120100000,1717,47,1764,,,
2120300000,12014,404,12418,,,
2120500000,14263,560,14823,,,
2120700000,13480,404,13884,,,
2120900000,35177,674,35851,,,
2121100000,29419,888,30307,,,
2121300000,12866,361,13227,,,
2121500000,13135,131,13266,,,
2121700000,17725,382,18107,,,
2121900000,8155,393,8548,,,
2122100000,11119,313,11432,,,
2122300000,6880,219,7099,,,
2122500000,10195,275,10470,,,
2122700000,74822,1547,76369,,,
2122900000,8475,121,8596,,,
2123100000,14372,405,14777,,,
2123300000,9495,233,9728,,,
2123500000,26428,622,27050,,,
2123700000,5652,290,5942,,,
2123900000,19188,514,19702,,,
2200100000,37941,1413,39354,,,
2200300000,13146,813,13959,,,
2200500000,69330,3597,72927,,,
2200700000,14533,689,15222,,,
2200900000,23298,1781,25079,,,
2201100000,20718,1023,21741,,,
2201300000,9109,371,9480,,,
2201500000,64008,6528,70536,,,
2201700000,156586,10282,166868,,,
2201900000,119700,6722,126422,,,
2202100000,6352,250,6602,,,
2202300000,4959,299,5258,,,
2202500000,6422,498,6920,,,
2202700000,8683,382,9065,,,
2202900000,12363,1102,13465,,,
2203100000,17398,657,18055,,,
2203300000,269240,12659,281899,,,
2203500000,5252,181,5433,,,
2203700000,13458,301,13759,,,
2203900000,21194,1222,22416,,,
2204100000,13444,355,13799,,,
2204300000,11920,808,12728,,,
2204500000,45698,2193,47891,,,
2204700000,20636,1061,21697,,,
2204900000,9684,518,10202,,,
2205100000,253699,13008,266707,,,
2205300000,20077,893,20970,,,
2205500000,139816,8564,148380,,,
2205700000,54538,2604,57142,,,
2205900000,8510,105,8615,,,
2206100000,24882,2534,27416,,,
2206300000,74921,4393,79314,,,
2206500000,7433,343,7776,,,
2206700000,18042,1287,19329,,,
2206900000,23030,2367,25397,,,
2207100000,230882,19651,250533,,,
2207300000,97472,5956,103428,,,
2207500000,13490,2022,15512,,,
2207700000,14521,1268,15789,,,
2207900000,81029,3261,84290,,,
2208100000,5844,409,6253,,,
2208300000,13390,568,13958,,,
2208500000,14257,492,14749,,,
2208700000,24540,1159,25699,,,
2208900000,32657,1949,34606,,,
2209100000,8149,395,8544,,,
2209300000,15065,711,15776,,,
2209500000,27961,1750,29711,,,
2209700000,57543,2945,60488,,,
2209900000,34522,1623,36145,,,
2210100000,31609,1867,33476,,,
2210300000,153206,8962,162168,,,
2210500000,70438,4689,75127,,,
2210700000,3945,4,3949,,,
2210900000,59596,3845,63441,,,
2211100000,15305,291,15596,,,
2211300000,35758,1421,37179,,,
2211500000,22321,1525,23846,,,
2211700000,26039,1154,27193,,,
2211900000,23708,1951,25659,,,
2212100000,15554,817,16371,,,
2212300000,7071,353,7424,,,
2212500000,7299,315,7614,,,
2212700000,8878,467,9345,,,
2300000000,,,0.00%,,,
2300102060,15615,506,16121,,,
2300119105,3179,67,3246,,,
2300129255,3239,49,3288,,,
2300138565,1739,33,1772,,,
2300138740,24694,740,25434,,,
2300140035,6440,158,6598,,,
2300140665,1777,46,1823,,,
2300140770,1802,70,1872,,,
2300144585,2003,38,2041,,,
2300146160,2048,38,2086,,,
2300160020,4128,92,4220,,,
2300164570,3717,95,3812,,,
2300177800,4131,88,4219,,,
2300179585,1172,54,1226,,,
2300300800,253,1,254,,,
2300301220,137,1,138,,,
2300301710,934,14,948,,,
2300302760,52,2,54,,,
2300305385,648,2,650,,,
2300307065,413,33,446,,,
2300310565,5956,184,6140,,,
2300311020,147,7,154,,,
2300311300,296,4,300,,,
2300311335,203,5,208,,,
2300312000,326,4,330,,,
2300313900,298,12,310,,,
2300315395,181,0,181,,,
2300315990,62,1,63,,,
2300319210,171,2,173,,,
2300319420,627,8,635,,,
2300321380,903,21,924,,,
2300325615,2260,66,2326,,,
2300325755,2966,55,3021,,,
2300326735,778,3,781,,,
2300327120,69,0,69,,,
2300327855,5,0,5,,,
2300328590,305,2,307,,,
2300330690,117,0,117,,,
2300330725,63,1,64,,,
2300332195,84,7,91,,,
2300332685,54,0,54,,,
2300333385,853,27,880,,,
2300333980,3483,331,3814,,,
2300335065,588,7,595,,,
2300339300,1716,33,1749,,,
2300339965,623,13,636,,,
2300340595,648,13,661,,,
2300341715,313,3,316,,,
2300342450,63,0,63,,,
2300342520,2980,59,3039,,,
2300343255,1358,13,1371,,,
2300343710,1071,15,1086,,,
2300343990,172,1,173,,,
2300345180,163,1,164,,,
2300346685,559,7,566,,,
2300347175,38,1,39,,,
2300348120,33,0,33,,,
2300348575,336,2,338,,,
2300348960,409,3,412,,,
2300349415,480,11,491,,,
2300354385,549,4,553,,,
2300355435,124,1,125,,,
2300356205,58,1,59,,,
2300358060,291,7,298,,,
2300360300,373,2,375,,,
2300360825,6541,170,6711,,,
2300362400,123,4,127,,,
2300364780,868,10,878,,,
2300365025,355,4,359,,,
2300365200,208,3,211,,,
2300367790,823,10,833,,,
2300369260,180,0,180,,,
2300373472,125,0,125,,,
2300374405,218,6,224,,,
2300378570,1450,55,1505,,,
2300379270,203,2,205,,,
2300379865,381,3,384,,,
2300380285,965,77,1042,,,
2300382770,416,9,425,,,
2300383540,48,4,52,,,
2300383785,184,3,187,,,
2300386865,193,0,193,,,
2300387215,949,44,993,,,
2300502655,1181,18,1199,,,
2300507170,3992,110,4102,,,
2300508430,16873,608,17481,,,
2300510180,7786,151,7937,,,
2300511125,2908,71,2979,,,
2300515430,6208,134,6342,,,
2300524495,9429,110,9539,,,
2300526525,6488,181,6669,,,
2300527025,121,1,122,,,
2300528240,12657,238,12895,,,
2300528870,6035,120,6155,,,
2300531390,4040,46,4086,,,
2300531600,1803,119,1922,,,
2300541067,235,5,240,,,
2300548085,2921,57,2978,,,
2300548820,4025,78,4103,,,
2300553860,3100,37,3137,,,
2300560545,52665,1991,54656,,,
2300560685,1277,14,1291,,,
2300561945,3924,73,3997,,,
2300566145,15554,279,15833,,,
2300566775,1456,33,1489,,,
2300571990,19383,590,19973,,,
2300573670,7089,135,7224,,,
2300582105,12249,356,12605,,,
2300586025,12061,251,12312,,,
2300587845,7043,150,7193,,,
2300702235,359,5,364,,,
2300710740,634,10,644,,,
2300710915,367,9,376,,,
2300712595,916,14,930,,,
2300714205,138,1,139,,,
2300716165,238,0,238,,,
2300724005,564,3,567,,,
2300724775,6016,163,6179,,,
2300734820,695,24,719,,,
2300735625,3345,57,3402,,,
2300737025,1131,8,1139,,,
2300749345,1157,25,1182,,,
2300749520,568,6,574,,,
2300758445,915,21,936,,,
2300761840,1123,5,1128,,,
2300761875,195,0,195,,,
2300765655,101,2,103,,,
2300774825,980,12,992,,,
2300775980,440,8,448,,,
2300781300,374,6,380,,,
2300785850,2765,104,2869,,,
2300901185,208,2,210,,,
2300902165,82,3,85,,,
2300902865,4212,78,4290,,,
2300905700,2290,45,2335,,,
2300907800,748,9,757,,,
2300907975,807,11,818,,,
2300908815,3760,47,3807,,,
2300911265,1050,15,1065,,,
2300914905,195,0,195,,,
2300916935,1334,33,1367,,,
2300917145,1686,19,1705,,,
2300919770,319,10,329,,,
2300923200,5620,147,5767,,,
2300926350,1038,21,1059,,,
2300926595,42,2,44,,,
2300928450,1517,28,1545,,,
2300928975,41,0,41,,,
2300930970,1734,43,1777,,,
2300938180,1441,35,1476,,,
2300943430,360,8,368,,,
2300947630,1839,30,1869,,,
2300955505,1612,18,1630,,,
2300955855,55,2,57,,,
2300955890,566,15,581,,,
2300957920,1023,18,1041,,,
2300967300,988,15,1003,,,
2300969750,275,3,278,,,
2300972865,1534,17,1551,,,
2300974580,885,4,889,,,
2300974965,871,10,881,,,
2300975280,1261,18,1279,,,
2300975455,318,1,319,,,
2300977345,1169,7,1176,,,
2300977415,1166,34,1200,,,
2300978920,426,6,432,,,
2300980040,268,7,275,,,
2300986655,435,5,440,,,
2301100590,1411,18,1429,,,
2301102100,13431,417,13848,,,
2301104020,2460,36,2496,,,
2301104475,1882,43,1925,,,
2301112350,1918,22,1940,,,
2301112735,3026,69,3095,,,
2301113470,2309,37,2346,,,
2301124670,2391,44,2435,,,
2301124950,918,14,932,,,
2301127085,4357,104,4461,,,
2301130550,2063,52,2115,,,
2301140175,2505,72,2577,,,
2301143080,2040,62,2102,,,
2301146405,3166,38,3204,,,
2301147770,1341,19,1360,,,
2301154560,4406,89,4495,,,
2301159110,2118,35,2153,,,
2301161700,1271,30,1301,,,
2301162190,2125,23,2148,,,
2301163835,870,27,897,,,
2301168385,3020,46,3066,,,
2301178745,3113,47,3160,,,
2301179025,476,3,479,,,
2301180740,11728,291,12019,,,
2301180880,969,2,971,,,
2301182945,2800,46,2846,,,
2301186165,1773,28,1801,,,
2301186515,5864,112,5976,,,
2301186970,4831,91,4922,,,
2301301465,985,4,989,,,
2301309725,4004,170,4174,,,
2301315780,1090,15,1105,,,
2301326805,967,12,979,,,
2301333840,1115,52,1167,,,
2301335135,80,0,80,,,
2301344165,90,0,90,,,
2301351620,359,4,363,,,
2301356135,1278,33,1311,,,
2301363590,4770,143,4913,,,
2301363660,2651,40,2691,,,
2301365130,2017,24,2041,,,
2301372585,1216,19,1235,,,
2301376365,1931,44,1975,,,
2301378115,1712,40,1752,,,
2301379130,968,52,1020,,,
2301380215,2585,63,2648,,,
2301380425,1138,4,1142,,,
2301501010,585,5,590,,,
2301506050,2536,26,2562,,,
2301506120,1724,29,1753,,,
2301506855,635,10,645,,,
2301507485,2296,22,2318,,,
2301516235,1740,27,1767,,,
2301518475,1329,18,1347,,,
2301522675,1042,10,1052,,,
2301535695,1938,32,1970,,,
2301546335,68,0,68,,,
2301548645,1405,17,1422,,,
2301549660,1420,33,1453,,,
2301569645,396,4,400,,,
2301570240,793,9,802,,,
2301571955,545,5,550,,,
2301579550,3757,61,3818,,,
2301584135,598,15,613,,,
2301585010,1548,68,1616,,,
2301587075,2640,212,2852,,,
2301701325,671,1,672,,,
2301704825,2131,24,2155,,,
2301708150,1073,11,1084,,,
2301708710,1380,18,1398,,,
2301709550,117,2,119,,,
2301710005,808,12,820,,,
2301717250,920,10,930,,,
2301717740,1671,35,1706,,,
2301726910,2735,93,2828,,,
2301727505,139,0,139,,,
2301729710,638,9,647,,,
2301731110,226,0,226,,,
2301731670,878,9,887,,,
2301732370,910,19,929,,,
2301733315,1048,22,1070,,,
2301739422,32,0,32,,,
2301741365,914,15,929,,,
2301742835,30,1,31,,,
2301745285,1836,38,1874,,,
2301749275,286,15,301,,,
2301754000,3746,75,3821,,,
2301755960,1350,31,1381,,,
2301756310,3108,76,3184,,,
2301756625,3678,114,3792,,,
2301758270,1239,42,1281,,,
2301760405,1007,23,1030,,,
2301764185,317,4,321,,,
2301764290,4334,108,4442,,,
2301774510,229,6,235,,,
2301774685,235,2,237,,,
2301775035,715,11,726,,,
2301775595,295,5,300,,,
2301778465,74,1,75,,,
2301780635,1108,9,1117,,,
2301783890,1241,27,1268,,,
2301787355,1095,26,1121,,,
2301901115,624,10,634,,,
2301902795,22389,866,23255,,,
2301906575,816,38,854,,,
2301906680,1147,26,1173,,,
2301906925,7001,298,7299,,,
2301909200,252,22,274,,,
2301910670,1919,28,1947,,,
2301910810,122,1,123,,,
2301912105,950,78,1028,,,
2301912525,460,10,470,,,
2301913365,752,24,776,,,
2301914310,1458,28,1486,,,
2301914380,1977,38,2015,,,
2301917530,2383,76,2459,,,
2301917950,879,16,895,,,
2301918580,37,0,37,,,
2301921030,1270,84,1354,,,
2301922535,1653,41,1694,,,
2301922710,135,0,135,,,
2301923620,1187,10,1197,,,
2301923865,886,24,910,,,
2301924110,734,9,743,,,
2301927190,768,12,780,,,
2301927645,3137,63,3200,,,
2301929185,951,13,964,,,
2301930795,5434,183,5617,,,
2301932510,4273,90,4363,,,
2301933490,2608,59,2667,,,
2301934190,871,8,879,,,
2301934365,1025,20,1045,,,
2301936325,927,22,949,,,
2301937075,118,2,120,,,
2301937760,465,6,471,,,
2301938005,97,3,100,,,
2301938530,656,5,661,,,
2301938705,1852,33,1885,,,
2301939475,3233,74,3307,,,
2301941435,305,5,310,,,
2301944270,573,19,592,,,
2301944340,64,1,65,,,
2301945005,1034,16,1050,,,
2301945670,2536,49,2585,,,
2301945810,3486,87,3573,,,
2301947560,158,3,161,,,
2301948505,1122,14,1136,,,
2301949065,2172,64,2236,,,
2301955225,7087,197,7284,,,
2301955565,9367,206,9573,,,
2301955680,2888,54,2942,,,
2301957045,302,13,315,,,
2301957150,645,44,689,,,
2301957937,432,4,436,,,
2301959950,968,23,991,,,
2301960790,111,4,115,,,
2301967160,29,2,31,,,
2301973250,256,2,258,,,
2301973600,265,6,271,,,
2301974055,944,24,968,,,
2301978780,1393,23,1416,,,
2301981055,50,0,50,,,
2301986305,257,2,259,,,
2301987390,163,1,164,,,
2302100100,478,6,484,,,
2302101920,210,0,210,,,
2302103740,113,0,113,,,
2302106400,93,1,94,,,
2302108325,984,12,996,,,
2302118195,2888,64,2952,,,
2302129535,1648,6,1654,,,
2302130095,847,66,913,,,
2302137095,23,2,25,,,
2302137970,80,0,80,,,
2302144830,172,0,172,,,
2302146020,1807,70,1877,,,
2302146580,610,5,615,,,
2302156765,616,15,631,,,
2302165865,989,12,1001,,,
2302166950,452,5,457,,,
2302168140,179,0,179,,,
2302181405,176,3,179,,,
2302185710,121,5,126,,,
2302301570,422,7,429,,,
2302303355,6505,431,6936,,,
2302306260,2368,51,2419,,,
2302306365,2339,36,2375,,,
2302327295,930,14,944,,,
2302358515,1833,28,1861,,,
2302362645,2417,50,2467,,,
2302376960,7070,143,7213,,,
2302381930,1561,29,1590,,,
2302387460,2414,94,2508,,,
2302501395,1610,36,1646,,,
2302501885,731,12,743,,,
2302505000,708,11,719,,,
2302507380,52,0,52,,,
2302509655,362,2,364,,,
2302509935,1496,39,1535,,,
2302510495,60,0,60,,,
2302514555,927,44,971,,,
2302517285,26,0,26,,,
2302517460,636,15,651,,,
2302523410,724,2,726,,,
2302524320,4319,98,4417,,,
2302531355,705,9,714,,,
2302531740,1175,11,1186,,,
2302532895,155,5,160,,,
2302535345,668,56,724,,,
2302542660,3060,88,3148,,,
2302545110,497,4,501,,,
2302547140,137,10,147,,,
2302547455,362,1,363,,,
2302549205,696,17,713,,,
2302549835,2316,40,2356,,,
2302556520,1407,45,1452,,,
2302559005,2929,76,3005,,,
2302559705,68,0,68,,,
2302562995,328,11,339,,,
2302564850,1383,9,1392,,,
2302568910,6124,165,6289,,,
2302569155,726,3,729,,,
2302569505,796,29,825,,,
2302573845,455,2,457,,,
2302576190,74,2,76,,,
2302582840,58,0,58,,,
2302703950,4999,151,5150,,,
2302704125,676,23,699,,,
2302707870,688,7,695,,,
2302709270,891,19,910,,,
2302726280,857,21,878,,,
2302726420,550,12,562,,,
2302735240,555,7,562,,,
2302735450,436,15,451,,,
2302737585,573,12,585,,,
2302739055,681,10,691,,,
2302739755,1804,9,1813,,,
2302746475,765,13,778,,,
2302746790,765,4,769,,,
2302747245,652,7,659,,,
2302752845,1244,13,1257,,,
2302756450,1126,3,1129,,,
2302761210,504,5,509,,,
2302766565,943,38,981,,,
2302766635,2196,52,2248,,,
2302774475,1284,30,1314,,,
2302775525,1140,33,1173,,,
2302776610,580,12,592,,,
2302777625,706,27,733,,,
2302778255,1502,14,1516,,,
2302779480,577,15,592,,,
2302786760,2949,63,3012,,,
2302900001,147,0,147,,,
2302900380,860,7,867,,,
2302900660,366,15,381,,,
2302902480,977,9,986,,,
2302902970,163,1,164,,,
2302903670,382,3,385,,,
2302903810,50,4,54,,,
2302909585,2198,59,2257,,,
2302912175,220,3,223,,,
2302912455,942,20,962,,,
2302913610,13,0,13,,,
2302913750,298,2,300,,,
2302913820,434,16,450,,,
2302914100,140,3,143,,,
2302914940,88,1,89,,,
2302915920,379,0,379,,,
2302916410,460,8,468,,,
2302916865,49,2,51,,,
2302917355,217,6,223,,,
2302920960,980,16,996,,,
2302921730,1148,24,1172,,,
2302928660,122,0,122,,,
2302931530,695,15,710,,,
2302935905,406,11,417,,,
2302936010,943,5,948,,,
2302941610,1157,12,1169,,,
2302941960,1401,39,1440,,,
2302942100,762,18,780,,,
2302943640,372,6,378,,,
2302944760,115,0,115,,,
2302945600,974,21,995,,,
2302951375,125,6,131,,,
2302957090,500,5,505,,,
2302957780,600,2,602,,,
2302958165,588,2,590,,,
2302961035,691,11,702,,,
2302963275,424,10,434,,,
2302963940,214,4,218,,,
2302974125,834,82,916,,,
2302975770,40,3,43,,,
2302976895,163,6,169,,,
2302978675,138,0,138,,,
2302979375,52,0,52,,,
2302981685,113,6,119,,,
2302985185,409,0,409,,,
2302985290,168,1,169,,,
2303100275,1915,48,1963,,,
2303100730,2298,37,2335,,,
2303101605,3082,69,3151,,,
2303104720,5373,160,5533,,,
2303104860,13194,848,14042,,,
2303109410,5996,92,6088,,,
2303114485,1033,11,1044,,,
2303116725,1495,26,1521,,,
2303122955,5410,115,5525,,,
2303133665,3222,52,3274,,,
2303136535,9182,213,9395,,,
2303136745,2599,0,2599,,,
2303137270,6916,250,7166,,,
2303138425,4229,121,4350,,,
2303139195,1975,49,2024,,,
2303139405,2330,6,2336,,,
2303141750,3225,58,3283,,,
2303148750,1090,13,1103,,,
2303150325,3529,91,3620,,,
2303154980,1154,11,1165,,,
2303155085,5802,539,6341,,,
2303156870,1158,19,1177,,,
2303164675,13935,358,14293,,,
2303165760,13344,466,13810,,,
2303167475,1879,79,1958,,,
2303170030,5049,125,5174,,,
2303180530,4909,102,5011,,,
2303181475,7944,140,8084,,,
2303187985,11112,158,11270,,,
2309999901,346,9,355,,,
2309999902,353,1,354,,,
2309999903,228,3,231,,,
2309999904,487,4,491,,,
2309999905,261,5,266,,,
2400100000,42560,,42560,,,
2400300000,349313,,349313,,,
2400500000,521130,,521130,,,
2400900000,59976,,59976,,,
2401100000,18353,,18353,,,
2401300000,112946,,112946,,,
2401500000,61991,,61991,,,
2401700000,100449,,100449,,,
2401900000,20466,,20466,,,
2402100000,150895,,150895,,,
2402300000,19292,,19292,,,
2402500000,164780,,164780,,,
2402700000,195440,,195440,,,
2402900000,12724,,12724,,,
2403100000,634663,,634663,,,
2403300000,544677,,544677,,,
2403500000,33175,,33175,,,
2403700000,12999,,12999,,,
2403900000,64510,,64510,,,
2404100000,25663,,25663,,,
2404300000,90097,,90097,,,
2404500000,56696,,56696,,,
2404700000,35699,,35699,,,
2451000000,373171,,373171,,,
2500103600,31567,826,32393,,,
2500107175,12296,1292,13588,,,
2500107980,7110,673,7783,,,
2500112995,5394,188,5582,,,
2500116775,11077,762,11839,,,
2500119295,4052,146,4198,,,
2500123105,24385,0,24385,,,
2500129020,9860,350,10210,,,
2500139100,9241,1213,10454,,,
2500151440,5050,277,5327,,,
2500155500,2513,384,2897,,,
2500159735,14318,1642,15960,,,
2500170605,1697,62,1759,,,
2500174385,2499,86,2585,,,
2500182525,17148,1032,18180,,,
2500300555,5608,285,5893,,,
2500300975,342,0,342,,,
2500304545,1196,202,1398,,,
2500313345,2223,53,2276,,,
2500314010,1107,24,1131,,,
2500316180,4274,239,4513,,,
2500321360,915,18,933,,,
2500324120,532,1,533,,,
2500326815,4475,31,4506,,,
2500328180,469,45,514,,,
2500330315,1389,38,1427,,,
2500334340,2121,7,2128,,,
2500334655,3826,32,3858,,,
2500334970,3754,86,3840,,,
2500342460,585,31,616,,,
2500343300,124,1,125,,,
2500344385,186,0,186,,,
2500345420,1031,86,1117,,,
2500346225,7879,989,8868,,,
2500351580,990,97,1087,,,
2500353050,599,2,601,,,
2500353960,23762,4741,28503,,,
2500356795,1114,0,1114,,,
2500359665,562,0,562,,,
2500360225,475,0,475,,,
2500361065,2277,0,2277,,,
2500367595,1539,77,1616,,,
2500371095,318,0,318,,,
2500373335,423,0,423,,,
2500377990,1149,16,1165,,,
2500379985,4345,334,4679,,,
2500380685,627,13,640,,,
2500500520,6340,927,7267,,,
2500502690,22677,4417,27094,,,
2500505280,4211,69,4280,,,
2500516425,17150,6606,23756,,,
2500516950,4386,461,4847,,,
2500520100,14980,913,15893,,,
2500522130,10853,0,10853,,,
2500523000,38546,11363,49909,,,
2500525240,5390,812,6202,,,
2500538225,14260,989,15249,,,
2500545000,55381,181,55562,,,
2500546575,16323,2542,18865,,,
2500549970,10782,1165,11947,,,
2500556060,9741,247,9988,,,
2500556375,8028,648,8676,,,
2500560645,8873,814,9687,,,
2500562430,13049,592,13641,,,
2500568750,11650,276,11926,,,
2500569170,23799,8533,32332,,,
2500577570,10521,1060,11581,,,
2500701585,369,0,369,,,
2500713800,832,106,938,,,
2500721150,3242,50,3292,,,
2500726325,129,17,146,,,
2500750390,3247,475,3722,,,
2500769940,3314,48,3362,,,
2500778235,2460,24,2484,,,
2500901185,10547,715,11262,,,
2500901465,20962,2064,23026,,,
2500905595,23498,2248,25746,,,
2500907420,5598,354,5952,,,
2500916250,16651,2323,18974,,,
2500921850,2590,163,2753,,,
2500925625,5586,572,6158,,,
2500926150,17707,3359,21066,,,
2500927620,4699,31,4730,,,
2500927900,5067,552,5619,,,
2500929405,28836,13251,42087,,,
2500932310,10182,397,10579,,,
2500934550,26842,12828,39670,,,
2500937490,49110,741,49851,,,
2500937560,8056,1220,9276,,,
2500937995,4020,145,4165,,,
2500938400,13870,1203,15073,,,
2500940430,4161,382,4543,,,
2500940710,24914,5347,30261,,,
2500941095,5685,225,5910,,,
2500943580,2456,102,2558,,,
2500945175,4755,240,4995,,,
2500945245,11540,2145,13685,,,
2500946365,17207,1563,18770,,,
2500952490,33772,2064,35836,,,
2500957880,5201,346,5547,,,
2500958405,4220,247,4467,,,
2500959105,23163,3886,27049,,,
2500959245,5289,686,5975,,,
2500960015,16058,1604,17662,,,
2500968645,8749,1222,9971,,,
2500970150,4519,175,4694,,,
2500974595,2633,143,2776,,,
2500977150,3248,35,3283,,,
2501102095,1297,70,1367,,,
2501105560,1475,0,1475,,,
2501109595,1171,155,1326,,,
2501112505,792,0,792,,,
2501114885,1116,41,1157,,,
2501115200,1454,105,1559,,,
2501116670,3341,271,3612,,,
2501121780,998,73,1071,,,
2501125730,1066,2,1068,,,
2501127025,10118,1104,11222,,,
2501129475,223,37,260,,,
2501129650,512,0,512,,,
2501135180,1324,112,1436,,,
2501135285,530,11,541,,,
2501142040,63,0,63,,,
2501142285,5360,480,5840,,,
2501145490,693,0,693,,,
2501147835,1962,207,2169,,,
2501151265,4254,464,4718,,,
2501158335,272,3,275,,,
2501161135,1263,60,1323,,,
2501161905,1308,115,1423,,,
2501168400,1959,408,2367,,,
2501173265,553,0,553,,,
2501174525,627,54,681,,,
2501179110,1080,65,1145,,,
2501300765,16153,5311,21464,,,
2501306085,839,2,841,,,
2501308470,2546,79,2625,,,
2501313485,892,2,894,,,
2501313660,32149,3434,35583,,,
2501319645,10120,1106,11226,,,
2501326675,1154,0,1154,,,
2501328075,3406,334,3740,,,
2501330665,1819,0,1819,,,
2501330840,22005,3121,25126,,,
2501336300,10531,893,11424,,,
2501337175,11824,1440,13264,,,
2501342145,5432,211,5643,,,
2501342530,605,0,605,,,
2501352105,7603,664,8267,,,
2501358650,970,8,978,,,
2501365825,5855,616,6471,,,
2501367000,102189,1032,103221,,,
2501370045,368,0,368,,,
2501372390,1139,142,1281,,,
2501376030,20933,3389,24322,,,
2501377850,14133,2796,16929,,,
2501379740,9544,696,10240,,,
2501501325,20735,696,21431,,,
2501504825,8864,639,9503,,,
2501513590,891,6,897,,,
2501516040,719,0,719,,,
2501519330,10465,1109,11574,,,
2501526290,672,33,705,,,
2501526535,4182,201,4383,,,
2501527690,3482,189,3671,,,
2501529265,2315,262,2577,,,
2501531785,1369,51,1420,,,
2501540990,340,2,342,,,
2501546330,17352,2363,19715,,,
2501552560,942,113,1055,,,
2501554030,460,0,460,,,
2501562745,4329,0,4329,,,
2501564145,10891,0,10891,,,
2501572880,6010,326,6336,,,
2501576380,1240,52,1292,,,
2501579915,1898,12,1910,,,
2501582175,895,0,895,,,
2501700380,13701,609,14310,,,
2501701605,27798,3047,30845,,,
2501701955,2204,166,2370,,,
2501702130,9646,852,10498,,,
2501703005,4744,360,5104,,,
2501704615,8620,1042,9662,,,
2501705070,15993,2127,18120,,,
2501705805,22618,3641,26259,,,
2501707350,3267,258,3525,,,
2501709840,15656,1428,17084,,,
2501711000,49088,17199,66287,,,
2501711525,3819,142,3961,,,
2501713135,22100,1736,23836,,,
2501715060,12124,722,12846,,,
2501717475,15909,4280,20189,,,
2501717825,2110,136,2246,,,
2501721990,15226,4426,19652,,,
2501724925,31418,6309,37727,,,
2501727480,7022,732,7754,,,
2501730700,9341,689,10030,,,
2501731085,10191,411,10602,,,
2501731540,11850,961,12811,,,
2501735215,19924,1319,21243,,,
2501735425,4006,394,4400,,,
2501735950,6201,76,6277,,,
2501737000,37718,19769,57487,,,
2501737875,23790,6239,30029,,,
2501738715,18562,3008,21570,,,
2501739625,5945,1139,7084,,,
2501739835,31111,4774,35885,,,
2501740115,16933,2079,19012,,,
2501743895,20902,1890,22792,,,
2501745560,49272,6418,55690,,,
2501748955,9929,1076,11005,,,
2501752805,7190,907,8097,,,
2501756130,16006,1886,17892,,,
2501761380,2952,128,3080,,,
2501761590,3643,450,4093,,,
2501762535,37957,9472,47429,,,
2501767665,13543,1940,15483,,,
2501768050,4691,243,4934,,,
2501768260,11475,524,11999,,,
2501769415,18627,2650,21277,,,
2501770360,5969,315,6284,,,
2501771025,7395,740,8135,,,
2501772215,16416,993,17409,,,
2501772600,28948,4981,33929,,,
2501773440,21769,578,22347,,,
2501773790,9215,649,9864,,,
2501776135,14832,1202,16034,,,
2501777255,7716,447,8163,,,
2501780230,12095,3633,15728,,,
2501780510,14460,752,15212,,,
2501781035,21522,3119,24641,,,
2501943790,8199,407,8606,,,
2502102935,2866,264,3130,,,
2502104930,10400,0,10400,,,
2502107665,20898,4218,25116,,,
2502109175,31200,7415,38615,,,
2502111315,13749,1683,15432,,,
2502114640,5399,403,5802,,,
2502116495,16520,1794,18314,,,
2502117405,3968,115,4083,,,
2502124820,11269,813,12082,,,
2502125100,20641,53,20694,,,
2502130455,6736,444,7180,,,
2502139765,8430,0,8430,,,
2502139975,8806,162,8968,,,
2502141515,5320,193,5513,,,
2502141690,18762,1203,19965,,,
2502144105,20415,542,20957,,,
2502146050,6273,369,6642,,,
2502150250,18203,1653,19856,,,
2502154100,5183,519,5702,,,
2502155745,49606,11916,61522,,,
2502155955,16831,3177,20008,,,
2502160785,11813,559,12372,,,
2502167945,13802,4359,18161,,,
2502172495,16362,514,16876,,,
2502174175,16103,1241,17344,,,
2502178690,10333,371,10704,,,
2502178865,31404,2687,34091,,,
2502182315,7055,702,7757,,,
2502300170,11186,4,11190,,,
2502308085,14965,10,14975,,,
2502309000,52399,3481,55880,,,
2502311665,6542,1395,7937,,,
2502317895,11064,72,11136,,,
2502318455,8943,611,9554,,,
2502327795,4963,261,5224,,,
2502328285,9560,0,9560,,,
2502328495,6571,466,7037,,,
2502330210,16508,361,16869,,,
2502331645,8045,221,8266,,,
2502333220,8381,609,8990,,,
2502333920,7398,367,7765,,,
2502338540,3629,170,3799,,,
2502338855,18070,345,18415,,,
2502339450,4864,212,5076,,,
2502340850,14306,1781,16087,,,
2502350145,7426,114,7540,,,
2502352630,12322,420,12742,,,
2502354310,34310,4718,39028,,,
2502354415,2070,39,2109,,,
2502357600,3911,172,4083,,,
2502357775,11726,913,12639,,,
2502360330,13968,107,14075,,,
2502372985,14555,225,14780,,,
2502375260,4753,286,5039,,,
2502379530,9142,699,9841,,,
2502507000,288283,95485,383768,,,
2502513205,11275,2962,14237,,,
2502556585,22230,3962,26192,,,
2502580930,11245,512,11757,,,
2502701885,3746,463,4209,,,
2502702480,5537,809,6346,,,
2502702760,10843,807,11650,,,
2502703740,3187,297,3484,,,
2502705490,2026,66,2092,,,
2502706015,5419,792,6211,,,
2502706365,3467,38,3505,,,
2502707525,3151,0,3151,,,
2502709105,2119,105,2224,,,
2502712715,9630,0,9630,,,
2502714395,7714,1868,9582,,,
2502717300,5530,511,6041,,,
2502717685,6189,797,6986,,,
2502718560,1465,10,1475,,,
2502723875,17070,5133,22203,,,
2502725485,9433,2070,11503,,,
2502726430,10697,1415,12112,,,
2502728740,1536,208,1744,,,
2502728950,3907,265,4172,,,
2502730560,12034,805,12839,,,
2502730945,3832,0,3832,,,
2502731435,3063,148,3211,,,
2502734165,4436,347,4783,,,
2502734795,6528,812,7340,,,
2502735075,21742,4221,25963,,,
2502737420,6452,736,7188,,,
2502740255,3767,355,4122,,,
2502741165,17098,700,17798,,,
2502741340,7900,778,8678,,,
2502741585,2062,9,2071,,,
2502745105,731,8,739,,,
2502746820,10424,298,10722,,,
2502746925,9326,1100,10426,,,
2502747135,3082,231,3313,,,
2502750670,1272,42,1314,,,
2502751825,8014,736,8750,,,
2502752420,2824,297,3121,,,
2502753120,862,52,914,,,
2502753225,1188,0,1188,,,
2502755395,2529,161,2690,,,
2502758580,857,34,891,,,
2502758825,5580,247,5827,,,
2502761800,21623,1293,22916,,,
2502763165,6627,504,7131,,,
2502763270,9156,2395,11551,,,
2502766105,6873,719,7592,,,
2502767385,5495,279,5774,,,
2502768155,6101,457,6558,,,
2502768610,6079,686,6765,,,
2502769275,4862,76,4938,,,
2502771480,4877,214,5091,,,
2502771620,8674,1225,9899,,,
2502773090,2937,238,3175,,,
2502773895,10209,1384,11593,,,
2502775015,10003,1340,11343,,,
2502775155,5008,198,5206,,,
2502775400,2294,141,2435,,,
2502777010,4948,373,5321,,,
2502780405,5586,763,6349,,,
2502782000,78538,29890,108428,,,
2600100000,8087,1232,9319,,,
2600300000,6209,1049,7258,,,
2600500000,73926,7643,81569,,,
2600700000,19775,3571,23346,,,
2600900000,18138,1958,20096,,,
2601100000,10879,1386,12265,,,
2601300000,5385,1015,6400,,,
2601500000,39505,4666,44171,,,
2601700000,72988,7348,80336,,,
2601900000,13444,1262,14706,,,
2602100000,106591,19297,125888,,,
2602300000,26949,4865,31814,,,
2602500000,87898,13417,101315,,,
2602700000,34098,5930,40028,,,
2602900000,19648,2656,22304,,,
2603100000,19109,2364,21473,,,
2603300000,21286,2585,23871,,,
2603500000,20069,3049,23118,,,
2603700000,51001,4615,55616,,,
2603900000,9796,1372,11168,,,
2604100000,25084,4049,29133,,,
2604300000,18466,3477,21943,,,
2604500000,73640,7273,80913,,,
2604700000,25126,2686,27812,,,
2604900000,291080,41304,332384,,,
2605100000,18311,2935,21246,,,
2605300000,10979,2592,13571,,,
2605500000,66035,5849,71884,,,
2605700000,23637,2834,26471,,,
2605900000,28561,5065,33626,,,
2606100000,20324,3947,24271,,,
2606300000,22105,3119,25224,,,
2606500000,170794,27528,198322,,,
2606700000,38607,4203,42810,,,
2606900000,18710,3428,22138,,,
2607100000,8266,1238,9504,,,
2607300000,37377,5722,43099,,,
2607500000,100121,13493,113614,,,
2607700000,175122,21790,196912,,,
2607900000,12390,1915,14305,,,
2608100000,403635,38638,442273,,,
2608300000,1709,205,1914,,,
2608500000,7683,1259,8942,,,
2608700000,59727,6607,66334,,,
2608900000,17854,1860,19714,,,
2609100000,62837,9662,72499,,,
2609300000,129705,10624,140329,,,
2609500000,3632,679,4311,,,
2609700000,8393,1146,9539,,,
2609900000,557386,62888,620274,,,
2610100000,17159,2470,19629,,,
2610300000,43322,6677,49999,,,
2610500000,20220,2476,22696,,,
2610700000,23781,3628,27409,,,
2610900000,15857,3507,19364,,,
2611100000,57811,7940,65751,,,
2611300000,9693,1043,10736,,,
2611500000,100582,15259,115841,,,
2611700000,37321,4704,42025,,,
2611900000,7008,973,7981,,,
2612100000,113586,15478,129064,,,
2612300000,31274,4204,35478,,,
2612500000,846441,94096,940537,,,
2612700000,16861,2469,19330,,,
2612900000,14609,1827,16436,,,
2613100000,4815,917,5732,,,
2613300000,15031,2134,17165,,,
2613500000,5887,807,6694,,,
2613700000,17550,2808,20358,,,
2613900000,173422,15231,188653,,,
2614100000,9537,1259,10796,,,
2614300000,18808,3023,21831,,,
2614500000,134019,19648,153667,,,
2614700000,107881,14806,122687,,,
2614900000,37134,6927,44061,,,
2615100000,26298,3085,29383,,,
2615300000,5685,1011,6696,,,
2615500000,47401,5217,52618,,,
2615700000,36197,4736,40933,,,
2615900000,48327,7099,55426,,,
2616100000,241129,39360,280489,,,
2616300000,1170061,180444,1350505,,,
2616500000,21949,2989,24938,,,
2700100000,9938,,9938,,,
2700300000,202374,,202374,,,
2700500000,18486,,18486,,,
2700700000,24461,,24461,,,
2700900000,21651,,21651,,,
2701100000,3297,,3297,,,
2701300000,36267,,36267,,,
2701500000,15176,,15176,,,
2701700000,20436,,20436,,,
2701900000,58545,,58545,,,
2702100000,18116,,18116,,,
2702300000,6877,,6877,,,
2702500000,32472,,32472,,,
2702700000,31711,,31711,,,
2702900000,4702,,4702,,,
2703100000,3575,,3575,,,
2703300000,6406,,6406,,,
2703500000,38922,,38922,,,
2703700000,251195,,251195,,,
2703900000,11644,,11644,,,
2704100000,23822,,23822,,,
2704300000,8500,,8500,,,
2704500000,12088,,12088,,,
2704700000,17997,,17997,,,
2704900000,28240,,28240,,,
2705100000,3927,,3927,,,
2705300000,730677,,730677,,,
2705500000,12010,,12010,,,
2705700000,12572,,12572,,,
2705900000,22477,,22477,,,
2706100000,26739,,26739,,,
2706300000,5989,,5989,,,
2706500000,9227,,9227,,,
2706700000,23609,,23609,,,
2706900000,2673,,2673,,,
2707100000,7305,,7305,,,
2707300000,4431,,4431,,,
2707500000,7415,,7415,,,
2707700000,2462,,2462,,,
2707900000,16231,,16231,,,
2708100000,3402,,3402,,,
2708300000,13464,,13464,,,
2708500000,20501,,20501,,,
2708700000,2598,,2598,,,
2708900000,5085,,5085,,,
2709100000,12044,,12044,,,
2709300000,13565,,13565,,,
2709500000,14535,,14535,,,
2709700000,18744,,18744,,,
2709900000,20105,,20105,,,
2710100000,5053,,5053,,,
2710300000,19559,,19559,,,
2710500000,9488,,9488,,,
2710700000,3616,,3616,,,
2710900000,86660,,86660,,,
2711100000,34920,,34920,,,
2711300000,7459,,7459,,,
2711500000,15672,,15672,,,
2711700000,5277,,5277,,,
2711900000,16227,,16227,,,
2712100000,6982,,6982,,,
2712300000,299449,,299449,,,
2712500000,2193,,2193,,,
2712700000,9553,,9553,,,
2712900000,8533,,8533,,,
2713100000,36075,,36075,,,
2713300000,5328,,5328,,,
2713500000,8577,,8577,,,
2713700000,122803,,122803,,,
2713900000,79538,,79538,,,
2714100000,51569,,51569,,,
2714300000,8764,,8764,,,
2714500000,85130,,85130,,,
2714700000,20706,,20706,,,
2714900000,6047,,6047,,,
2715100000,5603,,5603,,,
2715300000,13192,,13192,,,
2715500000,2102,,2102,,,
2715700000,13061,,13061,,,
2715900000,7546,,7546,,,
2716100000,10705,,10705,,,
2716300000,154048,,154048,,,
2716500000,5635,,5635,,,
2716700000,3478,,3478,,,
2716900000,28599,,28599,,,
2717100000,74459,,74459,,,
2717300000,5460,,5460,,,
2800100000,19844,845,20689,,,
2800300000,23592,1144,24736,,,
2800500000,10042,292,10334,,,
2800700000,12650,275,12925,,,
2800900000,5753,,5753,,,
2801100000,21259,7441,28700,,,
2801300000,9592,613,10205,,,
2801500000,7261,451,7712,,,
2801700000,11687,,11687,,,
2801900000,5493,1182,6675,,,
2802100000,,,0.00%,,,
2802300000,12623,468,13091,,,
2802500000,14242,577,14819,,,
2802700000,,,0.00%,,,
2802900000,19660,672,20332,,,
2803100000,14256,104,14360,,,
2803300000,95372,916,96288,,,
2803500000,43571,5153,48724,,,
2803700000,5687,353,6040,,,
2803900000,14588,451,15039,,,
2804100000,7611,420,8031,,,
2804300000,16044,549,16593,,,
2804500000,28218,2790,31008,,,
2804700000,106578,14059,120637,,,
2804900000,,,0.00%,,,
2805100000,11853,1215,13068,,,
2805300000,,,0.00%,,,
2805500000,1167,99,1266,,,
2805700000,15171,59,15230,,,
2805900000,80553,7277,87830,,,
2806100000,11352,,11352,,,
2806300000,,,0.00%,,,
2806500000,,,0.00%,,,
2806700000,,,0.00%,,,
2806900000,,,0.00%,,,
2807100000,29408,,29408,,,
2807300000,33085,2428,35513,,,
2807500000,44769,9081,53850,,,
2807700000,9158,317,9475,,,
2807900000,16017,1108,17125,,,
2808100000,46632,6694,53326,,,
2808300000,,,0.00%,,,
2808500000,,,0.00%,,,
2808700000,38985,4801,43786,,,
2808900000,75192,6783,81975,,,
2809100000,16642,1361,18003,,,
2809300000,20775,2262,23037,,,
2809500000,24400,854,25254,,,
2809700000,6831,1124,7955,,,
2809900000,,,0.00%,,,
2810100000,13202,628,13830,,,
2810300000,9212,7,9219,,,
2810500000,25449,96,25545,,,
2810700000,24224,,24224,,,
2810900000,36312,835,37147,,,
2811100000,8780,72,8852,,,
2811300000,21860,3876,25736,,,
2811500000,19640,326,19966,,,
2811700000,15565,1637,17202,,,
2811900000,5269,31,5300,,,
2812100000,86763,,86763,,,
2812300000,19082,687,19769,,,
2812500000,,,0.00%,,,
2812700000,,,0.00%,,,
2812900000,,,0.00%,,,
2813100000,9710,1034,10744,,,
2813300000,16069,777,16846,,,
2813500000,,,0.00%,,,
2813700000,,,0.00%,,,
2813900000,14226,1069,15295,,,
2814100000,12138,514,12652,,,
2814300000,6615,3097,9712,,,
2814500000,15881,1317,17198,,,
2814700000,12210,0,12210,,,
2814900000,29861,3538,33399,,,
2815100000,,,0.00%,,,
2815300000,13141,1168,14309,,,
2815500000,7432,172,7604,,,
2815700000,,,0.00%,,,
2815900000,12952,381,13333,,,
2816100000,,,0.00%,,,
2816300000,,,0.00%,,,
2900100000,12157,2501,14658,,,
2900300000,10981,892,11873,,,
2900500000,3674,269,3943,,,
2900700000,13483,1890,15373,,,
2900900000,18283,2077,20360,,,
2901100000,7912,722,8634,,,
2901300000,10881,420,11301,,,
2901500000,12438,1112,13550,,,
2901700000,7939,248,8187,,,
2901900000,96626,20324,116950,,,
2902100000,46855,7468,54323,,,
2902300000,24821,4700,29521,,,
2902500000,5992,63,6055,,,
2902700000,25046,3164,28210,,,
2902900000,27428,2527,29955,,,
2903100000,47312,5450,52762,,,
2903300000,5924,349,6273,,,
2903500000,4476,112,4588,,,
2903700000,67927,3414,71341,,,
2903900000,7892,301,8193,,,
2904100000,5288,347,5635,,,
2904300000,50011,4522,54533,,,
2904500000,4600,358,4958,,,
2904700000,135121,21377,156498,,,
2904900000,13382,944,14326,,,
2905100000,46672,6173,52845,,,
2905300000,10420,969,11389,,,
2905500000,14696,1299,15995,,,
2905700000,5614,298,5912,,,
2905900000,10025,884,10909,,,
2906100000,4835,192,5027,,,
2906300000,5900,650,6550,,,
2906500000,8736,998,9734,,,
2906700000,8839,1078,9917,,,
2906900000,16413,1390,17803,,,
2907100000,61326,8058,69384,,,
2907300000,9753,768,10521,,,
2907500000,4698,22,4720,,,
2907700000,159327,30869,190196,,,
2907900000,6218,523,6741,,,
2908100000,4731,563,5294,,,
2908300000,14181,1615,15796,,,
2908500000,6288,307,6595,,,
2908700000,3101,383,3484,,,
2908900000,6501,304,6805,,,
2909100000,23349,3237,26586,,,
2909300000,6292,610,6902,,,
2909500000,215005,31366,246371,,,
2909700000,64493,14833,79326,,,
2909900000,131567,6717,138284,,,
2910100000,27269,4814,32083,,,
2910300000,2491,119,2610,,,
2910500000,21314,1592,22906,,,
2910700000,21969,1380,23349,,,
2910900000,21606,2235,23841,,,
2911100000,6189,509,6698,,,
2911300000,31717,3313,35030,,,
2911500000,7831,819,8650,,,
2911700000,8841,650,9491,,,
2911900000,11538,900,12438,,,
2912100000,10065,294,10359,,,
2912300000,7523,88,7611,,,
2912500000,5747,461,6208,,,
2912700000,17414,1916,19330,,,
2912900000,2276,270,2546,,,
2913100000,15786,1320,17106,,,
2913300000,8266,606,8872,,,
2913500000,8707,579,9286,,,
2913700000,5724,139,5863,,,
2913900000,7586,563,8149,,,
2914100000,11464,1105,12569,,,
2914300000,10848,1573,12421,,,
2914500000,34422,5076,39498,,,
2914700000,11893,1633,13526,,,
2914900000,6719,624,7343,,,
2915100000,9008,407,9415,,,
2915300000,6784,166,6950,,,
2915500000,10300,1241,11541,,,
2915700000,11762,366,12128,,,
2915900000,24500,1528,26028,,,
2916100000,25363,3105,28468,,,
2916300000,9998,1098,11096,,,
2916500000,59128,5579,64707,,,
2916700000,17405,2220,19625,,,
2916900000,17303,3975,21278,,,
2917100000,3401,333,3734,,,
2917300000,6695,355,7050,,,
2917500000,14432,1463,15895,,,
2917700000,14538,3285,17823,,,
2917900000,4586,423,5009,,,
2918100000,8218,915,9133,,,
2918300000,234364,21566,255930,,,
2918500000,6175,501,6676,,,
2918600000,12317,629,12946,,,
2918700000,32962,4344,37306,,,
2918900000,671191,78686,749877,,,
2919500000,12769,1816,14585,,,
2919700000,2811,64,2875,,,
2919900000,2852,212,3064,,,
2920100000,23854,2563,26417,,,
2920300000,4906,219,5125,,,
2920500000,4271,342,4613,,,
2920700000,19197,1212,20409,,,
2920900000,20508,2605,23113,,,
2921100000,3565,827,4392,,,
2921300000,30337,4705,35042,,,
2921500000,14440,1600,16040,,,
2921700000,11536,1677,13213,,,
2921900000,20679,1252,21931,,,
2922100000,12838,1694,14532,,,
2922300000,8294,901,9195,,,
2922500000,20137,2582,22719,,,
2922700000,1478,42,1520,,,
2922900000,10981,1475,12456,,,
2938000000,181885,33732,215617,,,
2951000000,178751,39846,218597,,,
3000100000,5500,1088,6588,,,
3000300000,6759,1265,8024,,,
3000500000,3254,649,3903,,,
3000700000,3408,665,4073,,,
3000900000,6541,788,7329,,,
3001100000,897,105,1002,,,
3001300000,40217,11670,51887,,,
3001500000,3053,542,3595,,,
3001700000,5978,1222,7200,,,
3001900000,1136,88,1224,,,
3002100000,5238,261,5499,,,
3002300000,4624,374,4998,,,
3002500000,1623,317,1940,,,
3002700000,7110,903,8013,,,
3002900000,51138,10725,61863,,,
3003100000,53290,17740,71030,,,
3003300000,782,142,924,,,
3003500000,6435,885,7320,,,
3003700000,582,30,612,,,
3003900000,1984,205,2189,,,
3004100000,7698,1789,9487,,,
3004300000,7288,717,8005,,,
3004500000,1344,142,1486,,,
3004700000,15092,3594,18686,,,
3004900000,38222,4707,42929,,,
3005100000,1084,110,1194,,,
3005300000,10590,2513,13103,,,
3005500000,1128,38,1166,,,
3005700000,5391,470,5861,,,
3005900000,1077,295,1372,,,
3006100000,2825,279,3104,,,
3006300000,63954,22362,86316,,,
3006500000,2687,360,3047,,,
3006700000,10209,1723,11932,,,
3006900000,400,9,409,,,
3007100000,2478,141,2619,,,
3007300000,3319,160,3479,,,
3007500000,1149,123,1272,,,
3007700000,3057,434,3491,,,
3007900000,795,64,859,,,
3008100000,25073,4214,29287,,,
3008300000,5411,1237,6648,,,
3008500000,4607,1131,5738,,,
3008700000,4053,768,4821,,,
3008900000,6858,1296,8154,,,
3009100000,2092,256,2348,,,
3009300000,18893,1037,19930,,,
3009500000,5111,756,5867,,,
3009700000,2401,154,2555,,,
3009900000,3651,362,4013,,,
3010100000,2261,348,2609,,,
3010300000,539,31,570,,,
3010500000,4467,253,4720,,,
3010700000,1263,8,1271,,,
3010900000,649,83,732,,,
3011100000,78340,17631,95971,,,
3100100000,16552,2132,18684,,,
3100300000,4300,256,4556,,,
3100500000,321,4,325,,,
3100700000,514,20,534,,,
3100900000,346,30,376,,,
3101100000,3716,103,3819,,,
3101300000,6736,779,7515,,,
3101500000,1395,79,1474,,,
3101700000,2050,100,2150,,,
3101900000,24718,3310,28028,,,
3102100000,4423,450,4873,,,
3102300000,5257,452,5709,,,
3102500000,15523,1300,16823,,,
3102700000,5673,242,5915,,,
3102900000,2398,144,2542,,,
3103100000,3994,323,4317,,,
3103300000,6080,918,6998,,,
3103500000,3901,341,4242,,,
3103700000,4612,376,4988,,,
3103900000,5286,496,5782,,,
3104100000,6966,1126,8092,,,
3104300000,8808,1604,10412,,,
3104500000,4785,1199,5984,,,
3104700000,11912,1707,13619,,,
3104900000,1323,108,1431,,,
3105100000,3529,207,3736,,,
3105300000,19693,2185,21878,,,
3105500000,279784,45106,324890,,,
3105700000,1230,70,1300,,,
3105900000,3840,252,4092,,,
3106100000,2161,161,2322,,,
3106300000,1660,202,1862,,,
3106500000,3111,293,3404,,,
3106700000,12895,1063,13958,,,
3106900000,1417,98,1515,,,
3107100000,1228,30,1258,,,
3107300000,1348,134,1482,,,
3107500000,469,19,488,,,
3107700000,1603,73,1676,,,
3107900000,28207,4085,32292,,,
3108100000,5955,491,6446,,,
3108300000,2314,202,2516,,,
3108500000,707,36,743,,,
3108700000,1871,150,2021,,,
3108900000,6573,439,7012,,,
3109100000,542,42,584,,,
3109300000,4146,240,4386,,,
3109500000,4505,534,5039,,,
3109700000,2746,28,2774,,,
3109900000,4103,337,4440,,,
3110100000,5486,834,6320,,,
3110300000,615,35,650,,,
3110500000,2493,571,3064,,,
3110700000,5421,317,5738,,,
3110900000,153230,29219,182449,,,
3111100000,20376,3138,23514,,,
3111300000,530,34,564,,,
3111500000,452,65,517,,,
3111700000,337,23,360,,,
3111900000,18438,2588,21026,,,
3112100000,4009,835,4844,,,
3112300000,3072,199,3271,,,
3112500000,2228,177,2405,,,
3112700000,4087,607,4694,,,
3112900000,2948,224,3172,,,
3113100000,9266,1193,10459,,,
3113300000,1765,127,1892,,,
3113500000,1824,147,1971,,,
3113700000,5782,361,6143,,,
3113900000,4378,375,4753,,,
3114100000,17628,1807,19435,,,
3114300000,3277,166,3443,,,
3114500000,6479,692,7171,,,
3114700000,5303,724,6027,,,
3114900000,1006,21,1027,,,
3115100000,7073,830,7903,,,
3115300000,89374,12232,101606,,,
3115500000,13203,1215,14418,,,
3115700000,20387,3718,24105,,,
3115900000,9685,945,10630,,,
3116100000,3592,439,4031,,,
3116300000,2012,50,2062,,,
3116500000,881,46,927,,,
3116700000,3455,269,3724,,,
3116900000,3563,290,3853,,,
3117100000,478,52,530,,,
3117300000,3903,664,4567,,,
3117500000,2773,221,2994,,,
3117700000,12985,1060,14045,,,
3117900000,4661,539,5200,,,
3118100000,2323,160,2483,,,
3118300000,613,43,656,,,
3118500000,8958,1264,10222,,,
3200100000,12236,1640,13876,,,
3200300000,822922,203670,1026592,,,
3200500000,29253,4417,33670,,,
3200700000,18458,3928,22386,,,
3200900000,545,11,556,,,
3201100000,881,60,941,,,
3201300000,6340,877,7217,,,
3201500000,2438,285,2723,,,
3201700000,2695,284,2979,,,
3201900000,30020,1724,31744,,,
3202100000,2738,114,2852,,,
3202300000,23805,2896,26701,,,
3202700000,2292,164,2456,,,
3202900000,2436,334,2770,,,
3203100000,225345,41936,267281,,,
3203300000,4425,65,4490,,,
3251000000,25222,1881,27103,,,
3300101060,4147,0,4147,,,
3300103220,3106,0,3106,,,
3300104740,4591,0,4591,,,
3300110660,822,0,822,,,
3300128740,5876,0,5876,,,
3300128980,2424,0,2424,,,
3300140181,1759,0,1759,,,
3300140182,1494,0,1494,,,
3300140183,1586,0,1586,,,
3300140184,1542,0,1542,,,
3300140185,1381,0,1381,,,
3300140186,2078,0,2078,,,
3300147140,5019,0,5019,,,
3300151540,1584,0,1584,,,
3300167300,2206,0,2206,,,
3300177060,2407,0,2407,,,
3300300420,501,0,501,,,
3300303700,2166,0,2166,,,
3300307940,493,0,493,,,
3300311780,238,0,238,,,
3300314660,6639,0,6639,,,
3300323380,331,0,331,,,
3300323620,973,0,973,,,
3300327700,1165,0,1165,,,
3300332500,133,0,133,,,
3300334500,40,0,40,,,
3300338260,828,0,828,,,
3300345060,1569,0,1569,,,
3300349380,3788,0,3788,,,
3300358740,2805,0,2805,,,
3300367780,1064,0,1064,,,
3300376100,1971,0,1971,,,
3300377620,1858,0,1858,,,
3300378180,3596,0,3596,,,
3300386420,5162,0,5162,,,
3300500820,1208,0,1208,,,
3300512260,2646,0,2646,,,
3300519140,1191,0,1191,,,
3300526500,1635,0,1635,,,
3300529220,482,0,482,,,
3300534420,772,0,772,,,
3300536660,2344,0,2344,,,
3300538500,3522,0,3522,,,
3300539301,3672,0,3672,,,
3300539302,3449,0,3449,,,
3300539303,2633,0,2633,,,
3300539304,3225,0,3225,,,
3300539305,3308,0,3308,,,
3300545460,1441,0,1441,,,
3300545700,502,0,502,,,
3300550580,518,0,518,,,
3300564420,815,0,815,,,
3300564580,4120,0,4120,,,
3300565700,166,0,166,,,
3300573700,882,0,882,,,
3300574900,437,0,437,,,
3300575300,574,0,574,,,
3300575700,4525,0,4525,,,
3300577380,1311,0,1311,,,
3300578420,2576,0,2576,,,
3300582660,1249,0,1249,,,
3300585540,2532,0,2532,,,
3300702420,0,0,0,,,
3300704100,0,0,0,,,
3300704260,0,0,0,,,
3300705140,5027,0,5027,,,
3300708420,4,0,4,,,
3300710100,613,0,613,,,
3300711220,0,0,0,,,
3300713220,217,0,217,,,
3300713780,1343,0,1343,,,
3300713940,394,0,394,,,
3300716100,0,0,0,,,
3300716660,0,0,0,,,
3300716820,602,0,602,,,
3300718340,0,0,0,,,
3300718420,8,0,8,,,
3300719300,211,0,211,,,
3300725140,226,0,226,,,
3300725180,0,0,0,,,
3300730260,1913,0,1913,,,
3300731780,1,0,1,,,
3300732420,0,0,0,,,
3300738820,662,0,662,,,
3300739940,0,0,0,,,
3300740420,2046,0,2046,,,
3300743620,0,0,0,,,
3300746020,0,0,0,,,
3300747860,892,0,892,,,
3300748260,21,0,21,,,
3300756100,1192,0,1192,,,
3300757860,0,0,0,,,
3300761620,7,0,7,,,
3300761780,617,0,617,,,
3300763860,248,0,248,,,
3300767860,0,0,0,,,
3300768500,0,0,0,,,
3300768980,310,0,310,,,
3300773060,322,0,322,,,
3300773380,491,0,491,,,
3300774180,347,0,347,,,
3300774500,0,0,0,,,
3300776580,0,0,0,,,
3300780740,21,0,21,,,
3300784420,1414,0,1414,,,
3300900580,1059,0,1059,,,
3300902020,1434,0,1434,,,
3300903940,604,0,604,,,
3300905060,225,0,225,,,
3300905460,1775,0,1775,,,
3300907540,875,0,875,,,
3300907700,2010,0,2010,,,
3300908660,2532,0,2532,,,
3300908980,2390,0,2390,,,
3300918740,270,0,270,,,
3300922020,216,0,216,,,
3300923860,58,0,58,,,
3300924340,2945,0,2945,,,
3300927300,895,0,895,,,
3300930820,958,0,958,,,
3300932180,358,0,358,,,
3300933860,9330,0,9330,,,
3300934820,2534,0,2534,,,
3300935220,423,0,423,,,
3300936900,1552,0,1552,,,
3300940660,261,0,261,,,
3300941301,3195,0,3195,,,
3300941302,3015,0,3015,,,
3300941303,2592,0,2592,,,
3300941860,1039,0,1039,,,
3300942020,984,0,984,,,
3300942580,3726,0,3726,,,
3300942820,0,0,0,,,
3300944100,391,0,391,,,
3300944260,1339,0,1339,,,
3300948980,577,0,577,,,
3300958340,217,0,217,,,
3300958500,809,0,809,,,
3300961060,446,0,446,,,
3300962660,5484,0,5484,,,
3300965940,1029,0,1029,,,
3300974740,470,0,470,,,
3300976740,1776,0,1776,,,
3300978740,536,0,536,,,
3300979380,288,0,288,,,
3300980500,642,0,642,,,
3300987060,925,0,925,,,
3301101300,8395,0,8395,,,
3301101700,1854,0,1854,,,
3301104500,15316,0,15316,,,
3301104900,987,0,987,,,
3301108100,3630,0,3630,,,
3301117780,1277,0,1277,,,
3301127140,1076,0,1076,,,
3301129860,11338,0,11338,,,
3301131540,1125,0,1125,,,
3301131940,1160,0,1160,,,
3301133700,1277,0,1277,,,
3301136180,3471,0,3471,,,
3301137140,5943,0,5943,,,
3301137940,15996,0,15996,,,
3301142260,5826,0,5826,,,
3301144580,1205,0,1205,,,
3301145141,6008,0,6008,,,
3301145142,5306,0,5306,,,
3301145143,3427,0,3427,,,
3301145144,3883,0,3883,,,
3301145145,3236,0,3236,,,
3301145146,5299,0,5299,,,
3301145147,4114,0,4114,,,
3301145148,5436,0,5436,,,
3301145149,4580,0,4580,,,
3301145150,4611,0,4611,,,
3301145151,3585,0,3585,,,
3301145152,4630,0,4630,,,
3301146260,973,0,973,,,
3301147540,18258,0,18258,,,
3301148020,9865,0,9865,,,
3301149140,1809,0,1809,,,
3301150261,6315,0,6315,,,
3301150262,5908,0,5908,,,
3301150263,5173,0,5173,,,
3301150264,3992,0,3992,,,
3301150265,6275,0,6275,,,
3301150266,5227,0,5227,,,
3301150267,5098,0,5098,,,
3301150268,6080,0,6080,,,
3301150269,6220,0,6220,,,
3301150740,3850,0,3850,,,
3301151940,3302,0,3302,,,
3301159940,9077,0,9077,,,
3301160580,4890,0,4890,,,
3301168820,299,0,299,,,
3301176260,973,0,973,,,
3301179780,5978,0,5978,,,
3301185220,2728,0,2728,,,
3301185940,122,0,122,,,
3301300660,2749,0,2749,,,
3301301460,1695,0,1695,,,
3301306260,2380,0,2380,,,
3301306500,6038,0,6038,,,
3301306980,1130,0,1130,,,
3301309860,1827,0,1827,,,
3301312420,1837,0,1837,,,
3301314201,3024,0,3024,,,
3301314202,2550,0,2550,,,
3301314203,1943,0,1943,,,
3301314204,2689,0,2689,,,
3301314205,3261,0,3261,,,
3301314206,2609,0,2609,,,
3301314207,3185,0,3185,,,
3301314208,2507,0,2507,,,
3301314209,2506,0,2506,,,
3301314210,3337,0,3337,,,
3301316980,785,0,785,,,
3301319460,2035,0,2035,,,
3301324900,3228,0,3228,,,
3301327381,1675,0,1675,,,
3301327382,1327,0,1327,,,
3301327383,1695,0,1695,,,
3301335540,3239,0,3239,,,
3301335860,725,0,725,,,
3301337300,9089,0,9089,,,
3301337540,4586,0,4586,,,
3301343380,3717,0,3717,,,
3301350900,1633,0,1633,,,
3301352100,3645,0,3645,,,
3301354260,2967,0,2967,,,
3301360020,4868,0,4868,,,
3301361940,2454,0,2454,,,
3301366980,1009,0,1009,,,
3301375460,1424,0,1424,,,
3301378580,2031,0,2031,,,
3301380020,1267,0,1267,,,
3301384900,997,0,997,,,
3301502340,5395,0,5395,,,
3301502820,3848,0,3848,,,
3301507220,2910,0,2910,,,
3301509300,2988,0,2988,,,
3301512100,3353,0,3353,,,
3301517140,2974,0,2974,,,
3301517460,3285,0,3285,,,
3301517940,20420,0,20420,,,
3301521380,1696,0,1696,,,
3301524660,4558,0,4558,,,
3301525380,11247,0,11247,,,
3301527940,3181,0,3181,,,
3301531700,2837,0,2837,,,
3301532900,5937,0,5937,,,
3301533060,12304,0,12304,,,
3301533460,1867,0,1867,,,
3301539780,1698,0,1698,,,
3301540100,4008,0,4008,,,
3301543220,16129,0,16129,,,
3301550980,933,0,933,,,
3301551380,1213,0,1213,,,
3301551620,666,0,666,,,
3301552340,7023,0,7023,,,
3301552900,3166,0,3166,,,
3301554580,3705,0,3705,,,
3301556820,3072,0,3072,,,
3301557460,3449,0,3449,,,
3301562500,5116,0,5116,,,
3301562901,3371,0,3371,,,
3301562902,3654,0,3654,,,
3301562903,3040,0,3040,,,
3301562904,2707,0,2707,,,
3301562905,3360,0,3360,,,
3301564020,6535,0,6535,,,
3301566180,4724,0,4724,,,
3301566660,19653,0,19653,,,
3301567620,3786,0,3786,,,
3301568260,5522,0,5522,,,
3301571140,640,0,640,,,
3301574340,5813,0,5813,,,
3301585780,10291,0,10291,,,
3301703460,6103,0,6103,,,
3301718821,3657,0,3657,,,
3301718822,3611,0,3611,,,
3301718823,4194,0,4194,,,
3301718824,3785,0,3785,,,
3301718825,2941,0,2941,,,
3301718826,2813,0,2813,,,
3301719700,10900,0,10900,,,
3301726020,3907,0,3907,,,
3301741460,3134,0,3134,,,
3301744820,1465,0,1465,,,
3301747700,1141,0,1141,,,
3301748660,2933,0,2933,,,
3301751220,1951,0,1951,,,
3301765141,3136,0,3136,,,
3301765142,3187,0,3187,,,
3301765143,3151,0,3151,,,
3301765144,2870,0,2870,,,
3301765145,3023,0,3023,,,
3301765146,2732,0,2732,,,
3301765540,1921,0,1921,,,
3301769941,1722,0,1722,,,
3301769942,1419,0,1419,,,
3301769943,1366,0,1366,,,
3301769944,1378,0,1378,,,
3301769945,1062,0,1062,,,
3301773860,3130,0,3130,,,
3301900260,682,0,682,,,
3301911380,2929,0,2929,,,
3301912901,1814,0,1814,,,
3301912902,2391,0,2391,,,
3301912903,2055,0,2055,,,
3301915060,1223,0,1223,,,
3301916340,514,0,514,,,
3301930500,547,0,547,,,
3301931220,2531,0,2531,,,
3301940900,445,0,445,,,
3301941700,809,0,809,,,
3301952580,3679,0,3679,,,
3301962340,1547,0,1547,,,
3301972740,951,0,951,,,
3301975060,2465,0,2465,,,
3301977940,1014,0,1014,,,
3301978980,736,0,736,,,
3400100000,153751,20746,174497,,,
3400300000,511728,45517,557245,,,
3400500000,273459,14558,288017,,,
3400700000,312910,24985,337895,,,
3400900000,62520,5705,68225,,,
3401100000,79371,14558,93929,,,
3401300000,402288,111677,513965,,,
3401500000,184280,13676,197956,,,
3401700000,269567,47871,317438,,,
3401900000,84882,3732,88614,,,
3402100000,199334,32347,231681,,,
3402300000,423869,72660,496529,,,
3402500000,399008,23797,422805,,,
3402700000,304845,18889,323734,,,
3402900000,354748,32572,387320,,,
3403100000,259938,33048,292986,,,
3403300000,39917,2862,42779,,,
3403500000,193974,27830,221804,,,
3403700000,91709,10545,102254,,,
3403900000,278311,42981,321292,,,
3404100000,62785,8731,71516,,,
3500100000,328912,108255,437167,,,
3500300000,2522,626,3148,,,
3500500000,26852,1653,28505,,,
3500600000,12519,2462,14981,,,
3500700000,7547,1958,9505,,,
3500900000,17949,5731,23680,,,
3501100000,1232,222,1454,,,
3501300000,82272,33497,115769,,,
3501500000,24962,6932,31894,,,
3501700000,19177,2206,21383,,,
3501900000,3287,271,3558,,,
3502100000,724,51,775,,,
3502300000,2705,618,3323,,,
3502500000,26931,4930,31861,,,
3502700000,11424,3064,14488,,,
3502800000,11324,2562,13886,,,
3502900000,9295,3475,12770,,,
3503100000,35859,4085,39944,,,
3503300000,3439,639,4078,,,
3503500000,24712,9632,34344,,,
3503700000,5252,840,6092,,,
3503900000,23406,2589,25995,,,
3504100000,7952,2495,10447,,,
3504300000,74112,14792,88904,,,
3504500000,58515,15861,74376,,,
3504700000,17827,4424,22251,,,
3504900000,78055,23998,102053,,,
3505100000,5801,2370,8171,,,
3505300000,9888,2470,12358,,,
3505500000,21720,3492,25212,,,
3505700000,8321,1988,10309,,,
3505900000,2103,607,2710,,,
3506100000,36014,7918,43932,,,
3600100000,174161,25888,200049,,,
3600300000,23982,2392,26374,,,
3600500000,641376,83200,724576,,,
3600700000,109658,15647,125305,,,
3600900000,44201,5160,49361,,,
3601100000,44826,6726,51552,,,
3601300000,76239,9630,85869,,,
3601500000,49621,5554,55175,,,
3601700000,27881,3098,30979,,,
3601900000,44747,5858,50605,,,
3602100000,40155,3411,43566,,,
3602300000,26692,4745,31437,,,
3602500000,25966,2940,28906,,,
3602700000,167373,20383,187756,,,
3602900000,575698,41142,616840,,,
3603100000,24070,2822,26892,,,
3603300000,24779,2772,27551,,,
3603500000,30957,1142,32099,,,
3603700000,35208,2201,37409,,,
3603900000,28667,3199,31866,,,
3604100000,4254,630,4884,,,
3604300000,37150,3321,40471,,,
3604500000,55321,9087,64408,,,
3604700000,1301079,112280,1413359,,,
3604900000,16842,373,17215,,,
3605100000,36420,3662,40082,,,
3605300000,39457,4178,43635,,,
3605500000,439562,28022,467584,,,
3605700000,26936,3274,30210,,,
3605900000,945157,27254,972411,,,
3606100000,920487,129018,1049505,,,
3606300000,126305,13375,139680,,,
3606500000,123382,12082,135464,,,
3606700000,276003,27640,303643,,,
3606900000,66239,5161,71400,,,
3607100000,204969,18521,223490,,,
3607300000,22280,2100,24380,,,
3607500000,68709,6693,75402,,,
3607700000,32502,3901,36403,,,
3607900000,59714,4859,64573,,,
3608100000,1031849,68355,1100204,,,
3608300000,93825,9140,102965,,,
3608500000,265209,15509,280718,,,
3608700000,178372,13080,191452,,,
3608900000,57200,5639,62839,,,
3609100000,142758,20667,163425,,,
3609300000,89554,9176,98730,,,
3609500000,17654,2722,20376,,,
3609700000,11416,1269,12685,,,
3609900000,18832,1282,20114,,,
3610100000,55923,4389,60312,,,
3610300000,903100,69325,972425,,,
3610500000,44960,6018,50978,,,
3610700000,29815,3099,32914,,,
3610900000,49703,10188,59891,,,
3611100000,108356,7543,115899,,,
3611300000,39948,5323,45271,,,
3611500000,33275,3545,36820,,,
3611700000,53350,3735,57085,,,
3611900000,546752,51922,598674,,,
3612100000,23184,1735,24919,,,
3612300000,13374,1136,14510,,,
3700100000,85831,9480,95311,,,
3700300000,22484,1708,24192,,,
3700500000,6727,520,7247,,,
3700700000,16114,1206,17320,,,
3700900000,17022,1576,18598,,,
3701100000,10364,1806,12170,,,
3701300000,30121,2625,32746,,,
3701500000,13579,847,14426,,,
3701700000,21336,1434,22770,,,
3701900000,77647,8492,86139,,,
3702100000,157444,29474,186918,,,
3702300000,52952,4828,57780,,,
3702500000,110278,11706,121984,,,
3702700000,49326,4281,53607,,,
3702900000,6675,743,7418,,,
3703100000,45546,5432,50978,,,
3703300000,14402,1113,15515,,,
3703500000,91655,10386,102041,,,
3703700000,44073,3286,47359,,,
3703900000,19879,2040,21919,,,
3704100000,9480,1063,10543,,,
3704300000,8106,835,8941,,,
3704500000,54771,7313,62084,,,
3704700000,33550,3633,37183,,,
3704900000,55972,13650,69622,,,
3705100000,175617,29105,204722,,,
3705300000,15838,1869,17707,,,
3705500000,25200,2839,28039,,,
3705700000,94497,9768,104265,,,
3705900000,26676,1932,28608,,,
3706100000,26919,2510,29429,,,
3706300000,180063,29850,209913,,,
3706500000,36813,2249,39062,,,
3706700000,221652,25077,246729,,,
3706900000,37680,3044,40724,,,
3707100000,119790,14602,134392,,,
3707300000,7668,753,8421,,,
3707500000,6060,610,6670,,,
3707700000,33844,3112,36956,,,
3707900000,10478,815,11293,,,
3708100000,315609,41659,357268,,,
3708300000,34481,3636,38117,,,
3708500000,60606,9296,69902,,,
3708700000,38033,4357,42390,,,
3708900000,71941,6668,78609,,,
3709100000,13953,1031,14984,,,
3709300000,25684,4741,30425,,,
3709500000,3380,110,3490,,,
3709700000,100641,11183,111824,,,
3709900000,22758,3985,26743,,,
3710100000,101711,10070,111781,,,
3710300000,6602,875,7477,,,
3710500000,30878,3576,34454,,,
3710700000,35722,3473,39195,,,
3710900000,47326,5240,52566,,,
3711100000,25569,2849,28418,,,
3711300000,22461,2619,25080,,,
3711500000,14828,1679,16507,,,
3711700000,16168,1314,17482,,,
3711900000,586618,96450,683068,,,
3712100000,10200,1439,11639,,,
3712300000,14800,1270,16070,,,
3712500000,58455,5615,64070,,,
3712700000,60788,6383,67171,,,
3712900000,135407,23797,159204,,,
3713100000,13599,1753,15352,,,
3713300000,79031,17893,96924,,,
3713500000,95960,13243,109203,,,
3713700000,8847,678,9525,,,
3713900000,24545,3871,28416,,,
3714100000,33603,3599,37202,,,
3714300000,8948,986,9934,,,
3714500000,24104,1828,25932,,,
3714700000,102232,14330,116562,,,
3714900000,13993,1506,15499,,,
3715100000,79792,10472,90264,,,
3715300000,27377,3155,30532,,,
3715500000,65723,9197,74920,,,
3715700000,54196,5346,59542,,,
3715900000,83263,9101,92364,,,
3716100000,39955,3888,43843,,,
3716300000,34926,2775,37701,,,
3716500000,20355,2257,22612,,,
3716700000,36850,3029,39879,,,
3716900000,28470,2168,30638,,,
3717100000,40665,3379,44044,,,
3717300000,8782,1687,10469,,,
3717500000,22034,2412,24446,,,
3717700000,2303,182,2485,,,
3717900000,127998,14305,142303,,,
3718100000,27301,2713,30014,,,
3718300000,591424,79315,670739,,,
3718500000,12690,743,13433,,,
3718700000,8237,651,8888,,,
3718900000,37416,8333,45749,,,
3719100000,65736,8040,73776,,,
3719300000,38854,2981,41835,,,
3719500000,50793,4725,55518,,,
3719700000,22113,1798,23911,,,
3719900000,12755,1637,14392,,,
3800100000,,,0,,,
3800300000,,,0,,,
3800500000,,,0,,,
3800700000,,,0,,,
3800900000,,,0,,,
3801100000,,,0,,,
3801300000,,,0,,,
3801500000,,,0,,,
3801700000,,,0,,,
3801900000,,,0,,,
3802100000,,,0,,,
3802300000,,,0,,,
3802500000,,,0,,,
3802700000,,,0,,,
3802900000,,,0,,,
3803100000,,,0,,,
3803300000,,,0,,,
3803500000,,,0,,,
3803700000,,,0,,,
3803900000,,,0,,,
3804100000,,,0,,,
3804300000,,,0,,,
3804500000,,,0,,,
3804700000,,,0,,,
3804900000,,,0,,,
3805100000,,,0,,,
3805300000,,,0,,,
3805500000,,,0,,,
3805700000,,,0,,,
3805900000,,,0,,,
3806100000,,,0,,,
3806300000,,,0,,,
3806500000,,,0,,,
3806700000,,,0,,,
3806900000,,,0,,,
3807100000,,,0,,,
3807300000,,,0,,,
3807500000,,,0,,,
3807700000,,,0,,,
3807900000,,,0,,,
3808100000,,,0,,,
3808300000,,,0,,,
3808500000,,,0,,,
3808700000,,,0,,,
3808900000,,,0,,,
3809100000,,,0,,,
3809300000,,,0,,,
3809500000,,,0,,,
3809700000,,,0,,,
3809900000,,,0,,,
3810100000,,,0,,,
3810300000,,,0,,,
3810500000,,,0,,,
3900100000,13438,4100,17538,,,
3900300000,56006,10557,66563,,,
3900500000,29790,4546,34336,,,
3900700000,50044,11286,61330,,,
3900900000,30996,12738,43734,,,
3901100000,27551,4055,31606,,,
3901300000,37874,11557,49431,,,
3901500000,22479,4904,27383,,,
3901700000,199646,36615,236261,,,
3901900000,15273,2901,18174,,,
3902100000,21623,3882,25505,,,
3902300000,73810,14409,88219,,,
3902500000,117094,16702,133796,,,
3902700000,21631,4401,26032,,,
3902900000,54305,11246,65551,,,
3903100000,18723,3927,22650,,,
3903300000,23998,4306,28304,,,
3903500000,736146,149409,885555,,,
3903700000,29317,4487,33804,,,
3903900000,21643,3797,25440,,,
3904100000,109937,11236,121173,,,
3904300000,44449,8664,53113,,,
3904500000,82969,14899,97868,,,
3904700000,12891,3017,15908,,,
3904900000,624993,179122,804115,,,
3905100000,24636,4292,28928,,,
3905300000,15206,3762,18968,,,
3905500000,56325,7845,64170,,,
3905700000,92542,19323,111865,,,
3905900000,19963,3892,23855,,,
3906100000,459639,85484,545123,,,
3906300000,42555,7698,50253,,,
3906500000,15114,2851,17965,,,
3906700000,8452,1683,10135,,,
3906900000,16721,2599,19320,,,
3907100000,21334,4814,26148,,,
3907300000,15128,2915,18043,,,
3907500000,15268,2752,18020,,,
3907700000,29754,5741,35495,,,
3907900000,17068,4362,21430,,,
3908100000,39062,9240,48302,,,
3908300000,33259,6076,39335,,,
3908500000,132161,21551,153712,,,
3908700000,32828,15006,47834,,,
3908900000,93973,18383,112356,,,
3909100000,25289,5020,30309,,,
3909300000,162526,41192,203718,,,
3909500000,249725,62813,312538,,,
3909700000,19864,3939,23803,,,
3909900000,140544,26770,167314,,,
3910100000,32165,7420,39585,,,
3910300000,103345,19388,122733,,,
3910500000,12384,2804,15188,,,
3910700000,25408,3996,29404,,,
3910900000,60039,10816,70855,,,
3911100000,8257,1508,9765,,,
3911300000,301731,72366,374097,,,
3911500000,7363,1340,8703,,,
3911700000,19315,4814,24129,,,
3911900000,43777,9576,53353,,,
3912100000,6931,1316,8247,,,
3912300000,25214,4176,29390,,,
3912500000,10620,2218,12838,,,
3912700000,17874,4356,22230,,,
3912900000,27976,4837,32813,,,
3913100000,14019,4142,18161,,,
3913300000,87104,17833,104937,,,
3913500000,23288,4301,27589,,,
3913700000,20872,2625,23497,,,
3913900000,64809,24025,88834,,,
3914100000,34724,7852,42576,,,
3914300000,32907,6656,39563,,,
3914500000,36995,10058,47053,,,
3914700000,29268,5925,35193,,,
3914900000,26528,6374,32902,,,
3915100000,213146,37304,250450,,,
3915300000,291394,66171,357565,,,
3915500000,108565,36074,144639,,,
3915700000,49167,9658,58825,,,
3915900000,29422,4652,34074,,,
3916100000,16522,3418,19940,,,
3916300000,6704,1731,8435,,,
3916500000,124651,22323,146974,,,
3916700000,34155,7857,42012,,,
3916900000,66738,6221,72959,,,
3917100000,20647,4085,24732,,,
3917300000,72058,24206,96264,,,
3917500000,12562,2807,15369,,,
4000100000,8717,2953,11670,,,
4000300000,2485,458,2943,,,
4000500000,6182,1121,7303,,,
4000700000,2761,458,3219,,,
4000900000,8511,2063,10574,,,
4001100000,4621,704,5325,,,
4001300000,19026,4570,23596,,,
4001500000,10998,2306,13304,,,
4001700000,55525,10633,66158,,,
4001900000,23712,5410,29122,,,
4002100000,18541,4688,23229,,,
4002300000,6960,1783,8743,,,
4002500000,1421,274,1695,,,
4002700000,117109,27366,144475,,,
4002900000,3429,531,3960,,,
4003100000,39026,12443,51469,,,
4003300000,3095,586,3681,,,
4003500000,6504,1369,7873,,,
4003700000,30939,5815,36754,,,
4003900000,12676,2816,15492,,,
4004100000,17663,4359,22022,,,
4004300000,2525,334,2859,,,
4004500000,2200,320,2520,,,
4004700000,23757,4717,28474,,,
4004900000,12402,2337,14739,,,
4005100000,25146,5265,30411,,,
4005300000,2514,391,2905,,,
4005500000,2320,578,2898,,,
4005700000,1159,282,1441,,,
4005900000,1706,283,1989,,,
4006100000,5796,1152,6948,,,
4006300000,5454,1154,6608,,,
4006500000,9563,2259,11822,,,
4006700000,2803,720,3523,,,
4006900000,5135,1122,6257,,,
4007100000,19538,4543,24081,,,
4007300000,6928,1072,8000,,,
4007500000,4082,738,4820,,,
4007700000,5305,1117,6422,,,
4007900000,21823,5308,27131,,,
4008100000,15484,2698,18182,,,
4008300000,20492,5043,25535,,,
4008500000,4624,1038,5662,,,
4008700000,18387,2999,21386,,,
4008900000,12772,2602,15374,,,
4009100000,9506,2089,11595,,,
4009300000,3706,493,4199,,,
4009500000,6310,1240,7550,,,
4009700000,17936,2946,20882,,,
4009900000,6250,1220,7470,,,
4010100000,29685,8016,37701,,,
4010300000,5226,1029,6255,,,
4010500000,4954,1067,6021,,,
4010700000,4629,1078,5707,,,
4010900000,303946,87790,391736,,,
4011100000,16381,3888,20269,,,
4011300000,21382,4354,25736,,,
4011500000,12301,3169,15470,,,
4011700000,7460,1703,9163,,,
4011900000,30306,8585,38891,,,
4012100000,20790,5089,25879,,,
4012300000,16759,3453,20212,,,
4012500000,29613,6628,36241,,,
4012700000,5703,950,6653,,,
4012900000,2046,274,2320,,,
4013100000,43943,9185,53128,,,
4013300000,9291,2201,11492,,,
4013500000,16455,4537,20992,,,
4013700000,21244,3825,25069,,,
4013900000,7465,2107,9572,,,
4014100000,3441,918,4359,,,
4014300000,268422,64708,333130,,,
4014500000,31744,7878,39622,,,
4014700000,25160,5138,30298,,,
4014900000,5400,826,6226,,,
4015100000,4138,774,4912,,,
4015300000,9092,2020,11112,,,
4100100000,9846,,9846,,,
4100300000,51525,,51525,,,
4100500000,229814,,229814,,,
4100700000,20884,,20884,,,
4100900000,28358,,28358,,,
4101100000,33684,,33684,,,
4101300000,12454,,12454,,,
4101500000,13109,,13109,,,
4101700000,99298,,99298,,,
4101900000,60123,,60123,,,
4102100000,1181,,1181,,,
4102300000,4424,,4424,,,
4102500000,4132,,4132,,,
4102700000,11519,,11519,,,
4102900000,119318,,119318,,,
4103100000,10106,,10106,,,
4103300000,51167,,51167,,,
4103500000,33261,,33261,,,
4103700000,4075,,4075,,,
4103900000,208096,,208096,,,
4104100000,27120,,27120,,,
4104300000,62923,,62923,,,
4104500000,11910,,11910,,,
4104700000,151622,,151622,,,
4104900000,4668,,4668,,,
4105100000,441161,,441161,,,
4105300000,44007,,44007,,,
4105500000,1148,,1148,,,
4105700000,14382,,14382,,,
4105900000,31687,,31687,,,
4106100000,14702,,14702,,,
4106300000,4588,,4588,,,
4106500000,12937,,12937,,,
4106700000,292424,,292424,,,
4106900000,891,,891,,,
4107100000,52219,,52219,,,
4200100000,56722,3317,60039,,,
4200300000,831319,53912,885231,,,
4200500000,37727,2235,39962,,,
4200700000,98926,7211,106137,,,
4200900000,28352,4039,32391,,,
4201100000,218114,20615,238729,,,
4201300000,68816,4223,73039,,,
4201500000,32748,2472,35220,,,
4201700000,394438,39933,434371,,,
4201900000,108828,9914,118742,,,
4202100000,75467,5854,81321,,,
4202300000,2697,417,3114,,,
4202500000,35138,3637,38775,,,
4202700000,85041,21724,106765,,,
4202900000,298051,23366,321417,,,
4203100000,20419,2399,22818,,,
4203300000,42005,8934,50939,,,
4203500000,17401,2960,20361,,,
4203700000,33439,3448,36887,,,
4203900000,46109,5812,51921,,,
4204100000,141462,10708,152170,,,
4204300000,158752,14718,173470,,,
4204500000,342514,37668,380182,,,
4204700000,17466,1682,19148,,,
4204900000,164998,13730,178728,,,
4205100000,67752,10362,78114,,,
4205300000,3151,149,3300,,,
4205500000,79653,9045,88698,,,
4205700000,8306,767,9073,,,
4205900000,19669,2381,22050,,,
4206100000,24475,3710,28185,,,
4206300000,44871,2769,47640,,,
4206500000,23314,5419,28733,,,
4206700000,12581,619,13200,,,
4206900000,128566,10475,139041,,,
4207100000,279979,26949,306928,,,
4207300000,48016,5474,53490,,,
4207500000,72648,6796,79444,,,
4207700000,191118,22548,213666,,,
4207900000,167162,22768,189930,,,
4208100000,59033,5162,64195,,,
4208300000,21551,2650,24201,,,
4208500000,63447,9370,72817,,,
4208700000,21090,3185,24275,,,
4208900000,90395,8127,98522,,,
4209100000,486494,45051,531545,,,
4209300000,10441,1715,12156,,,
4209500000,174555,21929,196484,,,
4209700000,48128,5381,53509,,,
4209900000,25326,1301,26627,,,
4210100000,876247,114630,990877,,,
4210300000,33385,1841,35226,,,
4210500000,9469,882,10351,,,
4210700000,75582,6856,82438,,,
4210900000,19010,2225,21235,,,
4211100000,42603,4775,47378,,,
4211300000,4201,21,4222,,,
4211500000,23576,1189,24765,,,
4211700000,22052,2743,24795,,,
4211900000,20222,1992,22214,,,
4212100000,28014,2825,30839,,,
4212300000,23510,5453,28963,,,
4212500000,120286,7497,127783,,,
4212700000,28190,2885,31075,,,
4212900000,210678,28783,239461,,,
4213100000,16178,0,16178,,,
4213300000,240597,26492,267089,,,
4400105140,13486,763,14249,,,
4400109280,14950,1397,16347,,,
4400173760,7336,674,8010,,,
4400318640,23842,1226,25068,,,
4400322240,10253,759,11012,,,
4400374300,58718,3948,62666,,,
4400377720,4589,559,5148,,,
4400378440,16962,2597,19559,,,
4400536820,4582,350,4932,,,
4400542400,2981,140,3121,,,
4400545460,10181,1067,11248,,,
4400549960,13225,760,13985,,,
4400557880,13066,554,13620,,,
4400570880,11594,1120,12714,,,
4400711800,10513,1291,11804,,,
4400714140,7335,1329,8664,,,
4400719180,51588,4356,55944,,,
4400720080,23672,1988,25660,,,
4400722960,31292,1926,33218,,,
4400727460,3784,178,3962,,,
4400730340,7529,568,8097,,,
4400737720,20808,1969,22777,,,
4400741500,16625,747,17372,,,
4400751760,23039,3989,27028,,,
4400752480,9577,551,10128,,,
4400754640,37310,5816,43126,,,
4400759000,103701,9447,113148,,,
4400764220,8116,335,8451,,,
4400766200,14238,1580,15818,,,
4400780780,24660,1608,26268,,,
4400914500,5904,477,6381,,,
4400925300,4855,290,5145,,,
4400935380,5735,237,5972,,,
4400948340,11386,662,12048,,,
4400950500,1357,86,1443,,,
4400951580,21138,842,21980,,,
4400961160,5677,449,6126,,,
4400967460,20084,2025,22109,,,
4400977000,16116,1587,17703,,,
4500100000,14580,2162,16742,,,
4500300000,102635,13070,115705,,,
4500500000,5803,1097,6900,,,
4500700000,106938,16272,123210,,,
4500900000,9590,1408,10998,,,
4501100000,13274,1919,15193,,,
4501300000,110042,29385,139427,,,
4501500000,104478,18555,123033,,,
4501700000,10283,1474,11757,,,
4501900000,252527,30886,283413,,,
4502100000,30708,5002,35710,,,
4502300000,20013,3137,23150,,,
4502500000,24764,3817,28581,,,
4502700000,22751,3371,26122,,,
4502900000,23432,3675,27107,,,
4503100000,41720,5849,47569,,,
4503300000,19449,3155,22604,,,
4503500000,89187,11588,100775,,,
4503700000,15657,2050,17707,,,
4503900000,15373,2166,17539,,,
4504100000,82221,12082,94303,,,
4504300000,41025,7755,48780,,,
4504500000,286194,38696,324890,,,
4504700000,39149,5693,44842,,,
4504900000,12806,1993,14799,,,
4505100000,177268,28573,205841,,,
4505300000,15575,1965,17540,,,
4505500000,39086,5544,44630,,,
4505700000,50040,5943,55983,,,
4505900000,36264,6024,42288,,,
4506100000,11947,1786,13733,,,
4506300000,161493,22430,183923,,,
4506500000,6635,979,7614,,,
4506700000,21335,3450,24785,,,
4506900000,17478,2637,20115,,,
4507100000,22123,2899,25022,,,
4507300000,45968,6154,52122,,,
4507500000,55936,12700,68636,,,
4507700000,62461,12156,74617,,,
4507900000,240386,43919,284305,,,
4508100000,11041,1747,12788,,,
4508300000,160830,25288,186118,,,
4508500000,63523,12062,75585,,,
4508700000,16993,2485,19478,,,
4508900000,21687,3318,25005,,,
4509100000,148625,18218,166843,,,
4600300000,1841,97,1938,,,
4600500000,10303,722,11025,,,
4600700000,1854,153,2007,,,
4600900000,3878,205,4083,,,
4601100000,17566,2637,20203,,,
4601300000,22540,2158,24698,,,
4601500000,3221,234,3455,,,
4601700000,933,18,951,,,
4601900000,6475,392,6867,,,
4602100000,1148,68,1216,,,
4602300000,5586,479,6065,,,
4602500000,2548,129,2677,,,
4602700000,7481,930,8411,,,
4602900000,16316,1351,17667,,,
4603100000,2397,128,2525,,,
4603300000,5933,460,6393,,,
4603500000,11210,862,12072,,,
4603700000,4069,179,4248,,,
4603900000,2860,156,3016,,,
4604100000,3364,45,3409,,,
4604300000,2151,97,2248,,,
4604500000,2837,119,2956,,,
4604700000,4913,654,5567,,,
4604900000,1535,71,1606,,,
4605100000,4857,297,5154,,,
4605300000,2756,197,2953,,,
4605500000,1341,43,1384,,,
4605700000,3826,93,3919,,,
4605900000,2443,118,2561,,,
4606100000,3335,398,3733,,,
4606300000,943,33,976,,,
4606500000,10817,623,11440,,,
4606700000,4767,216,4983,,,
4606900000,986,44,1030,,,
4607100000,1750,191,1941,,,
4607300000,1302,64,1366,,,
4607500000,705,22,727,,,
4607700000,3425,138,3563,,,
4607900000,9134,563,9697,,,
4608100000,16383,2775,19158,,,
4608300000,31412,1417,32829,,,
4608500000,2307,135,2442,,,
4608700000,3594,142,3736,,,
4608900000,1780,114,1894,,,
4609100000,2844,165,3009,,,
4609300000,15232,1582,16814,,,
4609500000,1233,3,1236,,,
4609700000,1577,106,1683,,,
4609900000,109813,10251,120064,,,
4610100000,4107,228,4335,,,
4610300000,64424,5212,69636,,,
4610500000,2140,89,2229,,,
4610700000,1833,59,1892,,,
4610900000,6380,578,6958,,,
4611100000,1550,91,1641,,,
4611300000,8189,268,8457,,,
4611500000,4219,268,4487,,,
4611700000,2007,11,2018,,,
4611900000,1040,22,1062,,,
4612100000,4877,580,5457,,,
4612300000,3727,190,3917,,,
4612500000,5606,220,5826,,,
4612700000,10682,1081,11763,,,
4612900000,3745,207,3952,,,
4613500000,13407,839,14246,,,
4613700000,1576,94,1670,,,
4700100000,39308,9656,48964,,,
4700300000,19568,4698,24266,,,
4700500000,8820,2908,11728,,,
4700700000,7531,1440,8971,,,
4700900000,70422,3697,74119,,,
4701100000,58215,4202,62417,,,
4701300000,22025,2416,24441,,,
4701500000,7203,1529,8732,,,
4701700000,15945,2644,18589,,,
4701900000,30737,1831,32568,,,
4702100000,22345,2942,25287,,,
4702300000,9294,1115,10409,,,
4702500000,16232,3385,19617,,,
4702700000,5355,563,5918,,,
4702900000,19925,2804,22729,,,
4703100000,26892,5129,32021,,,
4703300000,7423,1481,8904,,,
4703500000,35416,4613,40029,,,
4703700000,302317,70087,372404,,,
4703900000,6443,1057,7500,,,
4704100000,10324,2752,13076,,,
4704300000,24310,5932,30242,,,
4704500000,19466,3105,22571,,,
4704700000,23980,3151,27131,,,
4704900000,9517,3431,12948,,,
4705100000,21554,4321,25875,,,
4705300000,25919,4805,30724,,,
4705500000,16858,1805,18663,,,
4705700000,12046,2659,14705,,,
4705900000,38401,2957,41358,,,
4706100000,6657,1216,7873,,,
4706300000,31801,2514,34315,,,
4706500000,207625,23500,231125,,,
4706700000,4768,330,5098,,,
4706900000,13374,2984,16358,,,
4707100000,14448,1429,15877,,,
4707300000,27169,8874,36043,,,
4707500000,9831,2176,12007,,,
4707700000,14790,3513,18303,,,
4707900000,17061,2938,19999,,,
4708100000,12085,2068,14153,,,
4708300000,5027,527,5554,,,
4708500000,11694,943,12637,,,
4708700000,7193,1368,8561,,,
4708900000,27040,3687,30727,,,
4709100000,10470,783,11253,,,
4709300000,272788,21179,293967,,,
4709500000,3643,439,4082,,,
4709700000,13846,804,14650,,,
4709900000,22316,2547,24863,,,
4710100000,7629,712,8341,,,
4710300000,17429,3476,20905,,,
4710500000,29391,4320,33711,,,
4710700000,28260,2660,30920,,,
4710900000,13463,2012,15475,,,
4711100000,10221,3288,13509,,,
4711300000,51334,12886,64220,,,
4711500000,15067,4982,20049,,,
4711700000,14580,4276,18856,,,
4711900000,47977,5349,53326,,,
4712100000,6548,1137,7685,,,
4712300000,25173,6953,32126,,,
4712500000,79954,21056,101010,,,
4712700000,4506,121,4627,,,
4712900000,9712,2482,12194,,,
4713100000,16391,3747,20138,,,
4713300000,12209,1974,14183,,,
4713500000,5186,290,5476,,,
4713700000,3739,394,4133,,,
4713900000,12181,81,12262,,,
4714100000,34253,9896,44149,,,
4714300000,14969,5296,20265,,,
4714500000,28589,4325,32914,,,
4714700000,35362,4570,39932,,,
4714900000,134063,21756,155819,,,
4715100000,13505,1270,14775,,,
4715300000,9046,986,10032,,,
4715500000,51982,6885,58867,,,
4715700000,504948,35564,540512,,,
4715900000,10436,2254,12690,,,
4716100000,7353,1582,8935,,,
4716300000,82382,8661,91043,,,
4716500000,85562,18227,103789,,,
4716700000,31679,8471,40150,,,
4716900000,4541,846,5387,,,
4717100000,9341,2148,11489,,,
4717300000,9286,3123,12409,,,
4717500000,4207,301,4508,,,
4717700000,18575,3309,21884,,,
4717900000,62662,11190,73852,,,
4718100000,8649,1801,10450,,,
4718300000,15970,4755,20725,,,
4718500000,13341,3344,16685,,,
4718700000,118467,20572,139039,,,
4718900000,65862,11928,77790,,,
4800100000,23830,3108,26938,,,
4800300000,7634,887,8521,,,
4800500000,44073,5789,49862,,,
4800700000,13807,2011,15818,,,
4800900000,5775,523,6298,,,
4801100000,1330,5,1335,,,
4801300000,22324,2251,24575,,,
4801500000,17130,1432,18562,,,
4801700000,3298,227,3525,,,
4801900000,13091,882,13973,,,
4802100000,36829,5676,42505,,,
4802300000,2188,324,2512,,,
4802500000,14321,795,15116,,,
4802700000,135771,33106,168877,,,
4802900000,826592,132846,959438,,,
4803100000,6721,387,7108,,,
4803300000,440,0,440,,,
4803500000,10406,1418,11824,,,
4803700000,49576,7683,57259,,,
4803900000,165368,18120,183488,,,
4804100000,76708,16532,93240,,,
4804300000,6005,1027,7032,,,
4804500000,1019,114,1133,,,
4804700000,5599,793,6392,,,
4804900000,19792,2952,22744,,,
4805100000,9999,945,10944,,,
4805300000,24762,2628,27390,,,
4805500000,19667,1508,21175,,,
4805700000,11543,1158,12701,,,
4805900000,8023,815,8838,,,
4806100000,167177,19386,186563,,,
4806300000,6364,854,7218,,,
4806500000,3870,382,4252,,,
4806700000,17466,1833,19299,,,
4806900000,3562,403,3965,,,
4807100000,22541,2177,24718,,,
4807300000,24076,2868,26944,,,
4807500000,3239,169,3408,,,
4807700000,6667,464,7131,,,
4807900000,1644,128,1772,,,
4808100000,1968,154,2122,,,
4808300000,5263,639,5902,,,
4808500000,431883,53523,485406,,,
4808700000,1714,177,1891,,,
4808900000,11262,1070,12332,,,
4809100000,74235,7902,82137,,,
4809300000,8531,65,8596,,,
4809500000,1455,100,1555,,,
4809700000,21458,2523,23981,,,
4809900000,30061,4821,34882,,,
4810100000,1042,48,1090,,,
4810300000,2305,214,2519,,,
4810500000,2373,162,2535,,,
4810700000,3219,379,3598,,,
4810900000,1554,205,1759,,,
4811100000,2581,509,3090,,,
4811300000,1043797,160688,1204485,,,
4811500000,6768,631,7399,,,
4811700000,7437,1002,8439,,,
4811900000,3436,139,3575,,,
4812100000,347694,59346,407040,,,
4812300000,10744,1183,11927,,,
4812500000,1318,1,1319,,,
4812700000,6657,644,7301,,,
4812900000,2125,285,2410,,,
4813100000,7852,529,8381,,,
4813300000,9577,783,10360,,,
4813500000,60779,7701,68480,,,
4813700000,1321,183,1504,,,
4813900000,83153,9975,93128,,,
4814100000,350375,54205,404580,,,
4814300000,17732,2724,20456,,,
4814500000,9240,614,9854,,,
4814700000,17662,2,17664,,,
4814900000,14878,972,15850,,,
4815100000,2619,150,2769,,,
4815300000,3675,404,4079,,,
4815500000,840,76,916,,,
4815700000,325729,37418,363147,,,
4815900000,5821,836,6657,,,
4816100000,10298,733,11031,,,
4816300000,9354,615,9969,,,
4816500000,7497,581,8078,,,
4816700000,166777,25184,191961,,,
4816900000,2560,175,2735,,,
4817100000,16261,1913,18174,,,
4817300000,707,49,756,,,
4817500000,5070,456,5526,,,
4817700000,11362,745,12107,,,
4817900000,11194,1800,12994,,,
4818100000,65695,9046,74741,,,
4818300000,58726,9178,67904,,,
4818500000,13223,2052,15275,,,
4818700000,75106,8970,84076,,,
4818900000,16685,2656,19341,,,
4819100000,1811,225,2036,,,
4819300000,4907,474,5381,,,
4819500000,2786,286,3072,,,
4819700000,2256,309,2565,,,
4819900000,34375,1622,35997,,,
4820100000,1835538,227254,2062792,,,
4820300000,38932,2834,41766,,,
4820500000,2499,356,2855,,,
4820700000,2975,527,3502,,,
4820900000,88348,18233,106581,,,
4821100000,2269,13,2282,,,
4821300000,43140,6106,49246,,,
4821500000,284348,37216,321564,,,
4821700000,9007,13082,22089,,,
4821900000,11984,1533,13517,,,
4822100000,31632,4267,35899,,,
4822300000,19174,2301,21475,,,
4822500000,11253,1662,12915,,,
4822700000,14730,2055,16785,,,
4822900000,1567,158,1725,,,
4823100000,43326,5797,49123,,,
4823300000,11961,1471,13432,,,
4823500000,1170,143,1313,,,
4823700000,4301,494,4795,,,
4823900000,7987,361,8348,,,
4824100000,19429,2902,22331,,,
4824300000,1522,162,1684,,,
4824500000,130364,15534,145898,,,
4824700000,3601,252,3853,,,
4824900000,23536,2059,25595,,,
4825100000,75754,8323,84077,,,
4825300000,8746,1141,9887,,,
4825500000,7108,711,7819,,,
4825700000,54594,6986,61580,,,
4825900000,24066,2652,26718,,,
4826100000,250,96,346,,,
4826300000,569,41,610,,,
4826500000,29335,3316,32651,,,
4826700000,2576,183,2759,,,
4826900000,171,15,186,,,
4827100000,2054,236,2290,,,
4827300000,15311,2079,17390,,,
4827500000,2281,93,2374,,,
4827700000,26355,3336,29691,,,
4827900000,7813,500,8313,,,
4828100000,11343,909,12252,,,
4828300000,3671,423,4094,,,
4828500000,12122,566,12688,,,
4828700000,9031,850,9881,,,
4828900000,9880,1006,10886,,,
4829100000,36544,5721,42265,,,
4829300000,11987,1430,13417,,,
4829500000,1805,175,1980,,,
4829700000,6196,929,7125,,,
4829900000,13033,872,13905,,,
4830100000,98,24,122,,,
4830300000,130690,26364,157054,,,
4830500000,3573,294,3867,,,
4830700000,4618,604,5222,,,
4830900000,110368,12593,122961,,,
4831100000,646,49,695,,,
4831300000,6152,791,6943,,,
4831500000,6297,722,7019,,,
4831700000,2862,222,3084,,,
4831900000,2622,132,2754,,,
4832100000,18680,2296,20976,,,
4832300000,25309,2635,27944,,,
4832500000,25578,2828,28406,,,
4832700000,1389,146,1535,,,
4832900000,64870,10172,75042,,,
4833100000,12656,1755,14411,,,
4833300000,3096,272,3368,,,
4833500000,4143,421,4564,,,
4833700000,11622,1308,12930,,,
4833900000,247061,34544,281605,,,
4834100000,8237,1099,9336,,,
4834300000,7611,922,8533,,,
4834500000,768,23,791,,,
4834700000,27648,3093,30741,,,
4834900000,24021,3336,27357,,,
4835100000,8098,788,8886,,,
4835300000,7688,866,8554,,,
4835500000,165597,24582,190179,,,
4835700000,4656,315,4971,,,
4835900000,1212,133,1345,,,
4836100000,46307,4221,50528,,,
4836300000,15002,2044,17046,,,
4836500000,14298,1465,15763,,,
4836700000,70836,8279,79115,,,
4836900000,4149,238,4387,,,
4837100000,7276,870,8146,,,
4837300000,31947,5202,37149,,,
4837500000,45330,7463,52793,,,
4837700000,4214,1074,5288,,,
4837900000,6060,768,6828,,,
4838100000,71367,8805,80172,,,
4838300000,1610,165,1775,,,
4838500000,2215,222,2437,,,
4838700000,7315,612,7927,,,
4838900000,6217,337,6554,,,
4839100000,4636,406,5042,,,
4839300000,664,14,678,,,
4839500000,10355,1011,11366,,,
4839700000,46934,4853,51787,,,
4839900000,6034,255,6289,,,
4840100000,26849,3477,30326,,,
4840300000,6673,457,7130,,,
4840500000,5585,545,6130,,,
4840700000,15766,872,16638,,,
4840900000,34451,5490,39941,,,
4841100000,3649,68,3717,,,
4841300000,1682,146,1828,,,
4841500000,8309,1072,9381,,,
4841700000,1963,190,2153,,,
4841900000,13313,1260,14573,,,
4842100000,1360,162,1522,,,
4842300000,116244,10815,127059,,,
4842500000,5365,444,5809,,,
4842700000,28112,2086,30198,,,
4842900000,4952,636,5588,,,
4843100000,811,19,830,,,
4843300000,1011,0,1011,,,
4843500000,2170,324,2494,,,
4843700000,3669,444,4113,,,
4843900000,861699,138727,1000426,,,
4844100000,62940,12803,75743,,,
4844300000,700,123,823,,,
4844500000,6083,1098,7181,,,
4844700000,1154,63,1217,,,
4844900000,14201,1780,15981,,,
4845100000,52639,9120,61759,,,
4845300000,551023,106299,657322,,,
4845500000,10856,191,11047,,,
4845700000,12072,1070,13142,,,
4845900000,23744,2651,26395,,,
4846100000,2062,127,2189,,,
4846300000,14786,1492,16278,,,
4846500000,22659,3778,26437,,,
4846700000,30859,3666,34525,,,
4846900000,47342,4566,51908,,,
4847100000,25992,4168,30160,,,
4847300000,25756,4115,29871,,,
4847500000,5634,684,6318,,,
4847700000,20265,1977,22242,,,
4847900000,106813,8861,115674,,,
4848100000,22099,2564,24663,,,
4848300000,3076,371,3447,,,
4848500000,64024,5264,69288,,,
4848700000,7227,719,7946,,,
4848900000,11476,2,11478,,,
4849100000,235455,36157,271612,,,
4849300000,26546,2301,28847,,,
4849500000,3312,379,3691,,,
4849700000,32271,4050,36321,,,
4849900000,25949,1702,27651,,,
4850100000,3653,316,3969,,,
4850300000,10544,1115,11659,,,
4850500000,6797,323,7120,,,
4850700000,7779,942,8721,,,
4900100000,2986,557,3543,,,
4900300000,25391,3339,28730,,,
4900500000,50198,13606,63804,,,
4900700000,9768,1681,11449,,,
4900900000,680,170,850,,,
4901100000,136044,29665,165709,,,
4901300000,7729,887,8616,,,
4901500000,5803,1148,6951,,,
4901700000,2709,153,2862,,,
4901900000,4816,2035,6851,,,
4902100000,20997,4023,25020,,,
4902300000,5173,869,6042,,,
4902500000,3913,374,4287,,,
4902700000,5929,372,6301,,,
4902900000,5349,498,5847,,,
4903100000,918,47,965,,,
4903300000,1248,50,1298,,,
4903500000,440922,114887,555809,,,
4903700000,6329,1757,8086,,,
4903900000,11265,1057,12322,,,
4904100000,8834,1974,10808,,,
4904300000,24020,40,24060,,,
4904500000,24774,4171,28945,,,
4904700000,14150,3850,18000,,,
4904900000,249074,21616,270690,,,
4905100000,12923,1161,14084,,,
4905300000,67256,10665,77921,,,
4905500000,1536,108,1644,,,
4905700000,95457,18754,114211,,,
5000100325,970,40,1010,,,
5000108575,783,11,794,,,
5000109025,2505,215,2720,,,
5000116000,858,55,913,,,
5000126275,1988,101,2089,,,
5000128600,150,12,162,,,
5000129575,216,2,218,,,
5000131525,245,0,245,,,
5000139325,669,36,705,,,
5000140075,980,39,1019,,,
5000144350,4118,540,4658,,,
5000145550,1395,11,1406,,,
5000148700,1157,68,1225,,,
5000153725,802,0,802,,,
5000153950,434,4,438,,,
5000159650,421,37,458,,,
5000162575,4289,65,4354,,,
5000165050,998,23,1021,,,
5000170075,1292,4,1296,,,
5000174650,1517,65,1582,,,
5000176075,359,16,375,,,
5000183275,717,0,717,,,
5000183800,244,6,250,,,
5000301450,1763,18,1781,,,
5000304825,7577,1228,8805,,,
5000317725,1544,135,1679,,,
5000339025,107,4,111,,,
5000342850,3455,119,3574,,,
5000355000,290,14,304,,,
5000357025,2391,31,2422,,,
5000358600,496,42,538,,,
5000361000,461,27,488,,,
5000362875,3805,0,3805,,,
5000363175,521,12,533,,,
5000363550,3970,1046,5016,,,
5000369775,555,24,579,,,
5000371425,631,13,644,,,
5000385075,601,24,625,,,
5000385675,260,1,261,,,
5000502875,1239,46,1285,,,
5000510450,996,88,1084,,,
5000517125,1605,51,1656,,,
5000530550,639,30,669,,,
5000531825,1938,175,2113,,,
5000537900,321,19,340,,,
5000541725,2989,175,3164,,,
5000547725,424,0,424,,,
5000554400,596,61,657,,,
5000561525,838,35,873,,,
5000562200,6404,225,6629,,,
5000564075,289,6,295,,,
5000569925,126,2,128,,,
5000571575,653,46,699,,,
5000575700,633,30,663,,,
5000577125,864,50,914,,,
5000583500,490,24,514,,,
5000706550,887,41,928,,,
5000710675,28544,1819,30363,,,
5000713300,3140,49,3189,,,
5000714875,11306,196,11502,,,
5000724175,13421,2528,15949,,,
5000733475,3686,65,3751,,,
5000734600,1440,59,1499,,,
5000736700,3715,183,3898,,,
5000745250,5783,1585,7368,,,
5000759275,2951,37,2988,,,
5000762050,1295,54,1349,,,
5000764300,65,1,66,,,
5000766175,5177,350,5527,,,
5000773975,2281,125,2406,,,
5000780350,1432,99,1531,,,
5000784475,8113,108,8221,,,
5000785150,3444,1989,5433,,,
5000906325,136,1,137,,,
5000908725,862,16,878,,,
5000910075,71,0,71,,,
5000911800,580,19,599,,,
5000915250,712,63,775,,,
5000921250,177,8,185,,,
5000929125,53,3,56,,,
5000930775,172,11,183,,,
5000939700,76,0,76,,,
5000941425,952,9,961,,,
5000942475,131,9,140,,,
5000952750,122,5,127,,,
5000975175,70,0,70,,,
5001102500,837,103,940,,,
5001105425,943,15,958,,,
5001123875,1880,241,2121,,,
5001124925,3300,79,3379,,,
5001125225,1224,18,1242,,,
5001126500,858,27,885,,,
5001127100,826,48,874,,,
5001127700,3244,49,3293,,,
5001133025,1919,124,2043,,,
5001145850,798,65,863,,,
5001159125,1395,119,1514,,,
5001161675,853,60,913,,,
5001161750,11217,1585,12802,,,
5001164600,2436,51,2487,,,
5001171725,3407,347,3754,,,
5001300700,1339,144,1483,,,
5001329275,1448,113,1561,,,
5001335875,367,18,385,,,
5001350650,693,70,763,,,
5001367000,1393,41,1434,,,
5001504375,204,1,205,,,
5001511500,2858,25,2883,,,
5001523500,732,105,837,,,
5001523725,617,21,638,,,
5001535050,1980,52,2032,,,
5001537075,2020,26,2046,,,
5001546675,2969,434,3403,,,
5001570525,3296,450,3746,,,
5001577425,531,0,531,,,
5001585375,993,44,1037,,,
5001707375,1488,30,1518,,,
5001707600,893,33,926,,,
5001709325,901,0,901,,,
5001713525,895,27,922,,,
5001715700,896,79,975,,,
5001725675,666,68,734,,,
5001748175,1470,89,1559,,,
5001753425,732,36,768,,,
5001758075,2685,329,3014,,,
5001770675,850,47,897,,,
5001772400,2012,106,2118,,,
5001773075,733,53,786,,,
5001773675,940,0,940,,,
5001774950,454,30,484,,,
5001776750,697,0,697,,,
5001779975,437,23,460,,,
5001784175,2013,10,2023,,,
5001900475,615,6,621,,,
5001903550,1649,59,1708,,,
5001909850,609,72,681,,,
5001913150,635,21,656,,,
5001916150,645,38,683,,,
5001916300,788,0,788,,,
5001917350,2899,179,3078,,,
5001928075,786,7,793,,,
5001930175,536,51,587,,,
5001933775,370,13,383,,,
5001935575,691,54,745,,,
5001936325,311,15,326,,,
5001940525,505,62,567,,,
5001946450,464,18,482,,,
5001948850,3285,30,3315,,,
5001948925,1241,1,1242,,,
5001973525,925,25,950,,,
5001980200,372,7,379,,,
5001981700,267,10,277,,,
5002105200,646,55,701,,,
5002107750,2697,176,2873,,,
5002111950,2635,344,2979,,,
5002114350,972,44,1016,,,
5002114500,1722,52,1774,,,
5002116825,881,6,887,,,
5002125375,1602,57,1659,,,
5002134450,455,30,485,,,
5002135425,293,27,320,,,
5002137685,808,90,898,,,
5002144125,776,40,816,,,
5002144800,617,9,626,,,
5002147200,985,3,988,,,
5002147425,134,2,136,,,
5002154250,966,52,1018,,,
5002155450,321,37,358,,,
5002155600,2108,49,2157,,,
5002156875,2109,56,2165,,,
5002157250,998,57,1055,,,
5002161225,9902,152,10054,,,
5002161300,2672,0,2672,,,
5002165275,430,21,451,,,
5002171050,395,2,397,,,
5002172925,378,24,402,,,
5002175925,1496,0,1496,,,
5002177950,825,25,850,,,
5002180875,183,0,183,,,
5002182300,1521,57,1578,,,
5002303175,3851,1112,4963,,,
5002303250,5479,43,5522,,,
5002305650,1801,118,1919,,,
5002311125,1040,43,1083,,,
5002311350,1313,4,1317,,,
5002318550,1046,30,1076,,,
5002321925,1918,96,2014,,,
5002325825,1016,67,1083,,,
5002343600,1043,63,1106,,,
5002344500,1458,66,1524,,,
5002346000,6531,24,6555,,,
5002346225,1233,225,1458,,,
5002350275,2899,250,3149,,,
5002355825,890,2,892,,,
5002360625,489,58,547,,,
5002375325,1212,221,1433,,,
5002376525,1240,92,1332,,,
5002376975,3622,185,3807,,,
5002385525,641,33,674,,,
5002386125,693,26,719,,,
5002501900,210,0,210,,,
5002507900,7324,1152,8476,,,
5002509475,351,7,358,,,
5002517875,1053,62,1115,,,
5002518325,1607,51,1658,,,
5002528900,483,17,500,,,
5002530925,1614,0,1614,,,
5002531150,511,18,529,,,
5002536175,589,43,632,,,
5002540225,1244,44,1288,,,
5002543375,662,51,713,,,
5002548400,1252,15,1267,,,
5002557700,1521,179,1700,,,
5002560250,3222,264,3486,,,
5002570750,186,11,197,,,
5002573300,880,35,915,,,
5002574800,1619,67,1686,,,
5002576225,490,8,498,,,
5002581400,2251,48,2299,,,
5002583950,782,75,857,,,
5002584700,1407,169,1576,,,
5002584850,288,38,326,,,
5002701300,365,44,409,,,
5002702575,163,16,179,,,
5002702725,651,0,651,,,
5002705800,1231,84,1315,,,
5002708275,590,36,626,,,
5002712250,1061,2,1063,,,
5002713675,2168,102,2270,,,
5002732275,6412,2533,8945,,,
5002732425,2418,18,2436,,,
5002741275,1457,83,1540,,,
5002752900,2709,233,2942,,,
5002756050,384,105,489,,,
5002756350,719,29,748,,,
5002758375,468,31,499,,,
5002760100,770,34,804,,,
5002760850,1935,105,2040,,,
5002763775,830,4,834,,,
5002769550,792,44,836,,,
5002770375,490,9,499,,,
5002777500,2028,28,2056,,,
5002782000,483,7,490,,,
5002783050,806,4,810,,,
5002784925,2609,371,2980,,,
5002785975,2541,140,2681,,,
5100100000,21572,2002,23574,,,
5100300000,66244,5638,71882,,,
5100500000,9738,573,10311,,,
5100700000,8426,354,8780,,,
5100900000,19097,1013,20110,,,
5101100000,9926,402,10328,,,
5101300000,141059,20773,161832,,,
5101500000,42949,2422,45371,,,
5101700000,3072,176,3248,,,
5101900000,49871,3099,52970,,,
5102100000,4367,232,4599,,,
5102300000,22177,1052,23229,,,
5102500000,10264,635,10899,,,
5102700000,14669,1187,15856,,,
5102900000,9537,469,10006,,,
5103100000,33657,2133,35790,,,
5103300000,17500,1324,18824,,,
5103500000,17469,1197,18666,,,
5103600000,5078,238,5316,,,
5103700000,7697,589,8286,,,
5104100000,208408,14935,223343,,,
5104300000,9521,558,10079,,,
5104500000,3673,192,3865,,,
5104700000,27261,2516,29777,,,
5104900000,6232,560,6792,,,
5105100000,9946,916,10862,,,
5105300000,17209,942,18151,,,
5105700000,7121,384,7505,,,
5105900000,675188,35476,710664,,,
5106100000,44022,3244,47266,,,
5106300000,9930,495,10425,,,
5106500000,15896,984,16880,,,
5106700000,33223,2063,35286,,,
5106900000,48845,4060,52905,,,
5107100000,10547,680,11227,,,
5107300000,24465,1421,25886,,,
5107500000,15635,499,16134,,,
5107700000,9655,780,10435,,,
5107900000,11524,798,12322,,,
5108100000,6114,512,6626,,,
5108300000,22275,1262,23537,,,
5108500000,69834,2304,72138,,,
5108700000,193567,13527,207094,,,
5108900000,33256,2004,35260,,,
5109100000,1718,27,1745,,,
5109300000,25128,1598,26726,,,
5109500000,49457,3629,53086,,,
5109700000,4575,230,4805,,,
5109900000,14230,1057,15287,,,
5110100000,10763,421,11184,,,
5110300000,8214,414,8628,,,
5110500000,13985,1433,15418,,,
5110700000,200625,14632,215257,,,
5110900000,20727,1319,22046,,,
5111100000,7378,475,7853,,,
5111300000,8339,498,8837,,,
5111500000,6563,349,6912,,,
5111700000,19863,1869,21732,,,
5111900000,7366,409,7775,,,
5112100000,52694,6232,58926,,,
5112500000,10023,776,10799,,,
5112700000,13165,556,13721,,,
5113100000,8311,574,8885,,,
5113300000,9076,427,9503,,,
5113500000,8491,614,9105,,,
5113700000,20741,1748,22489,,,
5113900000,14207,977,15184,,,
5114100000,11264,804,12068,,,
5114300000,39879,2229,42108,,,
5114500000,18612,729,19341,,,
5114700000,12128,1647,13775,,,
5114900000,19619,1887,21506,,,
5115300000,232012,21765,253777,,,
5115500000,19862,1331,21193,,,
5115700000,5261,437,5698,,,
5115900000,4699,311,5010,,,
5116100000,62647,4320,66967,,,
5116300000,13171,678,13849,,,
5116500000,43916,2232,46148,,,
5116700000,17705,681,18386,,,
5116900000,13971,1419,15390,,,
5117100000,25246,1725,26971,,,
5117300000,17563,1683,19246,,,
5117500000,11368,939,12307,,,
5117700000,75841,6798,82639,,,
5117900000,76555,6516,83071,,,
5118100000,5184,267,5451,,,
5118300000,6580,515,7095,,,
5118500000,25348,1844,27192,,,
5118700000,22201,2092,24293,,,
5119100000,32915,2401,35316,,,
5119300000,10934,907,11841,,,
5119500000,21131,2201,23332,,,
5119700000,17281,1316,18597,,,
5119900000,40818,4173,44991,,,
5151000000,86452,11859,98311,,,
5152000000,10080,1413,11493,,,
5153000000,3445,460,3905,,,
5154000000,26383,5889,32272,,,
5155000000,135481,13853,149334,,,
5157000000,11226,787,12013,,,
5158000000,3314,383,3697,,,
5159000000,25531,2678,28209,,,
5159500000,3428,363,3791,,,
5160000000,14271,1225,15496,,,
5161000000,8527,777,9304,,,
5162000000,5213,506,5719,,,
5163000000,14721,1407,16128,,,
5164000000,3324,396,3720,,,
5165000000,80030,12549,92579,,,
5166000000,19442,5598,25040,,,
5167000000,12004,1575,13579,,,
5167800000,3424,504,3928,,,
5168000000,45195,8576,53771,,,
5168300000,19082,2570,21652,,,
5168500000,6309,571,6880,,,
5169000000,7917,923,8840,,,
5170000000,103601,11522,115123,,,
5171000000,103144,12794,115938,,,
5172000000,2181,189,2370,,,
5173000000,19399,2069,21468,,,
5173500000,8338,411,8749,,,
5174000000,55719,6454,62173,,,
5175000000,7291,596,7887,,,
5176000000,117244,12441,129685,,,
5177000000,53978,8348,62326,,,
5177500000,15436,1238,16674,,,
5179000000,14072,1294,15366,,,
5180000000,53197,4166,57363,,,
5181000000,266980,23102,290082,,,
5182000000,11256,969,12225,,,
5183000000,8867,1947,10814,,,
5184000000,13324,1719,15043,,,
5300100000,6230,673,6903,,,
5300300000,14244,1387,15631,,,
5300500000,98992,10166,109158,,,
5300700000,39836,3877,43713,,,
5300900000,46915,4912,51827,,,
5301100000,249407,31699,281106,,,
5301300000,2641,252,2893,,,
5301500000,58156,6567,64723,,,
5301700000,18952,2282,21234,,,
5301900000,4496,651,5147,,,
5302100000,30317,4316,34633,,,
5302300000,1541,182,1723,,,
5302500000,36480,5862,42342,,,
5302700000,37407,6179,43586,,,
5302900000,50272,6569,56841,,,
5303100000,22867,2607,25474,,,
5303300000,1181076,131357,1312433,,,
5303500000,154462,51100,205562,,,
5303700000,21882,3276,25158,,,
5303900000,13003,1633,14636,,,
5304100000,43772,3935,47707,,,
5304300000,6966,501,7467,,,
5304500000,35130,3522,38652,,,
5304700000,21174,2005,23179,,,
5304900000,13234,1092,14326,,,
5305100000,8137,1749,9886,,,
5305300000,441987,61864,503851,,,
5305500000,11985,860,12845,,,
5305700000,67205,8569,75774,,,
5305900000,6862,786,7648,,,
5306100000,416389,47993,464382,,,
5306300000,281536,31045,312581,,,
5306500000,28573,3893,32466,,,
5306700000,162655,19104,181759,,,
5306900000,2874,181,3055,,,
5307100000,31645,3941,35586,,,
5307300000,127280,13337,140617,,,
5307500000,19383,4182,23565,,,
5307700000,106415,9543,115958,,,
5400100000,8374,860,9234,,,
5400300000,53890,13901,67791,,,
5400500000,13409,5049,18458,,,
5400700000,7670,895,8565,,,
5400900000,17722,340,18062,,,
5401100000,43891,9320,53211,,,
5401300000,4228,1490,5718,,,
5401500000,4924,701,5625,,,
5401700000,4346,188,4534,,,
5401900000,24713,3249,27962,,,
5402100000,4491,250,4741,,,
5402300000,7102,464,7566,,,
5402500000,24326,662,24988,,,
5402700000,10964,3405,14369,,,
5402900000,22224,1588,23812,,,
5403100000,6871,1785,8656,,,
5403300000,41933,585,42518,,,
5403500000,18479,2730,21209,,,
5403700000,31809,1763,33572,,,
5403900000,133605,1482,135087,,,
5404100000,8389,1018,9407,,,
5404300000,11802,6102,17904,,,
5404500000,22081,4201,26282,,,
5404700000,16686,20,16706,,,
5404900000,37904,4195,42099,,,
5405100000,21161,953,22114,,,
5405300000,17007,220,17227,,,
5405500000,36803,1569,38372,,,
5405700000,16096,1917,18013,,,
5405900000,21499,154,21653,,,
5406100000,57526,2020,59546,,,
5406300000,9344,833,10177,,,
5406500000,11961,355,12316,,,
5406700000,13490,3276,16766,,,
5406900000,28793,529,29322,,,
5407100000,4457,630,5087,,,
5407300000,4787,45,4832,,,
5407500000,5057,236,5293,,,
5407700000,15722,1012,16734,,,
5407900000,35083,173,35256,,,
5408100000,46684,6547,53231,,,
5408300000,18002,363,18365,,,
5408500000,5179,1968,7147,,,
5408700000,8699,1115,9814,,,
5408900000,8554,885,9439,,,
5409100000,9398,1094,10492,,,
5409300000,5416,11,5427,,,
5409500000,5906,308,6214,,,
5409700000,11258,1919,13177,,,
5409900000,24425,3010,27435,,,
5410100000,4708,967,5675,,,
5410300000,11227,247,11474,,,
5410500000,4355,37,4392,,,
5410700000,51447,1774,53221,,,
5410900000,17421,51,17472,,,
5500100275,950,0,950,,,
5500100300,755,0,755,,,
5500107300,596,0,596,,,
5500116075,156,0,156,,,
5500119575,1064,0,1064,,,
5500122000,603,0,603,,,
5500127950,355,0,355,,,
5500137625,691,0,691,,,
5500143425,179,0,179,,,
5500144250,202,0,202,,,
5500153725,293,0,293,,,
5500156525,521,0,521,,,
5500156750,433,0,433,,,
5500165450,802,0,802,,,
5500165825,785,0,785,,,
5500167425,106,0,106,,,
5500169275,2171,0,2171,,,
5500176350,721,0,721,,,
5500177800,735,0,735,,,
5500188150,16,0,16,,,
5500300550,283,0,283,,,
5500303225,375,0,375,,,
5500303225,416,0,416,,,
5500303225,435,0,435,,,
5500303225,441,0,441,,,
5500303225,472,0,472,,,
5500303225,478,0,478,,,
5500303225,509,0,509,,,
5500303225,542,0,542,,,
5500303225,571,0,571,,,
5500303225,585,0,585,,,
5500303225,658,0,658,,,
5500303250,285,0,285,,,
5500311525,198,0,198,,,
5500314550,253,0,253,,,
5500329250,508,0,508,,,
5500329875,197,0,197,,,
5500337775,449,0,449,,,
5500342562,324,0,324,,,
5500349200,261,0,261,,,
5500350700,426,0,426,,,
5500354400,361,0,361,,,
5500361600,132,0,132,,,
5500371350,713,0,713,,,
5500372825,87,0,87,,,
5500386850,564,0,564,,,
5500501325,355,0,355,,,
5500501350,558,0,558,,,
5500502775,398,0,398,,,
5500504875,1716,0,1716,,,
5500504900,456,0,456,,,
5500505650,431,0,431,,,
5500512250,965,0,965,,,
5500513500,766,0,766,,,
5500514325,1275,0,1275,,,
5500514350,1227,0,1227,,,
5500515600,272,0,272,,,
5500517875,408,0,408,,,
5500518025,1302,0,1302,,,
5500518050,551,0,551,,,
5500518575,224,0,224,,,
5500518600,344,0,344,,,
5500520650,442,0,442,,,
5500520750,325,0,325,,,
5500533225,198,0,198,,,
5500541600,680,0,680,,,
5500548825,588,0,588,,,
5500548950,578,0,578,,,
5500556350,3,0,3,,,
5500556350,11,0,11,,,
5500558950,583,0,583,,,
5500565150,236,0,236,,,
5500565175,337,0,337,,,
5500565200,987,0,987,,,
5500567350,4895,0,4895,,,
5500567375,1896,0,1896,,,
5500574125,373,0,373,,,
5500576550,425,0,425,,,
5500576600,1578,0,1578,,,
5500578450,482,0,482,,,
5500581075,485,0,485,,,
5500581100,367,0,367,,,
5500582375,381,0,381,,,
5500703225,0,0,0,,,
5500704725,562,0,562,,,
5500704750,644,0,644,,,
5500705350,418,0,418,,,
5500705375,626,0,626,,,
5500705475,419,0,419,,,
5500706200,259,0,259,,,
5500711675,628,0,628,,,
5500715750,195,0,195,,,
5500719662,231,0,231,,,
5500720887,414,0,414,,,
5500722925,485,0,485,,,
5500730175,336,0,336,,,
5500736300,338,0,338,,,
5500737200,851,0,851,,,
5500739025,293,0,293,,,
5500739425,229,0,229,,,
5500744275,220,0,220,,,
5500749900,60,0,60,,,
5500749925,192,0,192,,,
5500755375,241,0,241,,,
5500760275,100,0,100,,,
5500760775,380,0,380,,,
5500762700,176,0,176,,,
5500764512,332,0,332,,,
5500770300,818,0,818,,,
5500780750,156,0,156,,,
5500783525,1468,0,1468,,,
5500783550,420,0,420,,,
5500901150,2088,0,2088,,,
5500901150,2171,0,2171,,,
5500901150,2354,0,2354,,,
5500901150,2641,0,2641,,,
5500903425,1528,0,1528,,,
5500903425,1611,0,1611,,,
5500903425,1816,0,1816,,,
5500903425,1839,0,1839,,,
5500903425,2077,0,2077,,,
5500903425,2348,0,2348,,,
5500906350,4608,0,4608,,,
5500906350,4798,0,4798,,,
5500919700,1303,0,1303,,,
5500919775,6,0,6,,,
5500919775,292,0,292,,,
5500919775,552,0,552,,,
5500919775,3014,0,3014,,,
5500919775,3714,0,3714,,,
5500919775,3869,0,3869,,,
5500919775,4222,0,4222,,,
5500922225,1046,0,1046,,,
5500929550,773,0,773,,,
5500931000,19,0,19,,,
5500931000,449,0,449,,,
5500931000,458,0,458,,,
5500931000,556,0,556,,,
5500931000,711,0,711,,,
5500931000,728,0,728,,,
5500931000,825,0,825,,,
5500931000,846,0,846,,,
5500931000,850,0,850,,,
5500931000,852,0,852,,,
5500931000,869,0,869,,,
5500931000,903,0,903,,,
5500931000,907,0,907,,,
5500931000,914,0,914,,,
5500931000,916,0,916,,,
5500931000,933,0,933,,,
5500931000,942,0,942,,,
5500931000,958,0,958,,,
5500931000,974,0,974,,,
5500931000,989,0,989,,,
5500931000,1021,0,1021,,,
5500931000,1045,0,1045,,,
5500931000,1051,0,1051,,,
5500931000,1075,0,1075,,,
5500931000,1081,0,1081,,,
5500931000,1086,0,1086,,,
5500931000,1109,0,1109,,,
5500931000,1127,0,1127,,,
5500931000,1148,0,1148,,,
5500931000,1241,0,1241,,,
5500931000,1339,0,1339,,,
5500931000,1373,0,1373,,,
5500931000,1387,0,1387,,,
5500931000,1430,0,1430,,,
5500931000,1442,0,1442,,,
5500931000,1443,0,1443,,,
5500931000,1458,0,1458,,,
5500931000,1490,0,1490,,,
5500931000,1602,0,1602,,,
5500931000,1606,0,1606,,,
5500931000,1760,0,1760,,,
5500931000,1913,0,1913,,,
5500931000,1955,0,1955,,,
5500931000,2001,0,2001,,,
5500931000,2135,0,2135,,,
5500931000,2147,0,2147,,,
5500931000,2454,0,2454,,,
5500931025,1379,0,1379,,,
5500935150,0,0,0,,,
5500935150,4812,0,4812,,,
5500935325,1047,0,1047,,,
5500935950,566,0,566,,,
5500935950,732,0,732,,,
5500935950,1533,0,1533,,,
5500935950,1610,0,1610,,,
5500935950,1619,0,1619,,,
5500935950,2234,0,2234,,,
5500935950,2396,0,2396,,,
5500935950,3326,0,3326,,,
5500936425,895,0,895,,,
5500942900,3690,0,3690,,,
5500943090,2329,0,2329,,,
5500943090,2613,0,2613,,,
5500954300,1099,0,1099,,,
5500956575,1082,0,1082,,,
5500963075,1833,0,1833,,,
5500965675,1857,0,1857,,,
5500968875,1226,0,1226,,,
5500972200,2605,0,2605,,,
5500977975,3747,0,3747,,,
5500977975,4296,0,4296,,,
5500989150,1629,0,1629,,,
5500989175,1417,0,1417,,,
5501101225,546,0,546,,,
5501101250,218,0,218,,,
5501106675,299,0,299,,,
5501111025,505,0,505,,,
5501111062,660,0,660,,,
5501112500,166,0,166,,,
5501116025,275,0,275,,,
5501117737,239,0,239,,,
5501120575,280,0,280,,,
5501126850,575,0,575,,,
5501129225,283,0,283,,,
5501129375,283,0,283,,,
5501144300,132,0,132,,,
5501150075,202,0,202,,,
5501152175,395,0,395,,,
5501153450,195,0,195,,,
5501153600,1532,0,1532,,,
5501153625,303,0,303,,,
5501153850,189,0,189,,,
5501155450,427,0,427,,,
5501155950,199,0,199,,,
5501155975,374,0,374,,,
5501184325,320,0,320,,,
5501301900,268,0,268,,,
5501308025,132,0,132,,,
5501318750,442,0,442,,,
5501319925,328,0,328,,,
5501330450,797,0,797,,,
5501330475,671,0,671,,,
5501337650,684,0,684,,,
5501340975,364,0,364,,,
5501344325,201,0,201,,,
5501350650,664,0,664,,,
5501359075,642,0,642,,,
5501369325,140,0,140,,,
5501370225,270,0,270,,,
5501371450,335,0,335,,,
5501372225,463,0,463,,,
5501374175,437,0,437,,,
5501374200,619,0,619,,,
5501378775,506,0,506,,,
5501380375,567,0,567,,,
5501381500,233,0,233,,,
5501384975,351,0,351,,,
5501385025,393,0,393,,,
5501385850,220,0,220,,,
5501388900,621,0,621,,,
5501502375,0,0,0,,,
5501502375,113,0,113,,,
5501502375,266,0,266,,,
5501502375,925,0,925,,,
5501502375,1213,0,1213,,,
5501502375,1337,0,1337,,,
5501502375,1398,0,1398,,,
5501502375,1521,0,1521,,,
5501509725,1836,0,1836,,,
5501509750,971,0,971,,,
5501510350,893,0,893,,,
5501514000,522,0,522,,,
5501514475,2160,0,2160,,,
5501514500,712,0,712,,,
5501532790,3024,0,3024,,,
5501532790,3104,0,3104,,,
5501532800,889,0,889,,,
5501534575,667,0,667,,,
5501538800,0,0,0,,,
5501539525,179,0,179,,,
5501550825,1663,0,1663,,,
5501556800,2042,0,2042,,,
5501556825,922,0,922,,,
5501564675,186,0,186,,,
5501566275,514,0,514,,,
5501573525,1985,0,1985,,,
5501577400,477,0,477,,,
5501577425,1097,0,1097,,,
5501589000,586,0,586,,,
5501702175,4,0,4,,,
5501702175,1420,0,1420,,,
5501703075,450,0,450,,,
5501703725,429,0,429,,,
5501707525,355,0,355,,,
5501708225,2166,0,2166,,,
5501708250,627,0,627,,,
5501709075,348,0,348,,,
5501711750,781,0,781,,,
5501714575,0,0,0,,,
5501714575,977,0,977,,,
5501714575,1005,0,1005,,,
5501714575,1019,0,1019,,,
5501714575,1047,0,1047,,,
5501714575,1105,0,1105,,,
5501714575,1151,0,1151,,,
5501714575,1291,0,1291,,,
5501715350,527,0,527,,,
5501716125,487,0,487,,,
5501716800,485,0,485,,,
5501717100,813,0,813,,,
5501719625,557,0,557,,,
5501721600,2203,0,2203,,,
5501722300,0,0,0,,,
5501722300,49,0,49,,,
5501722300,1055,0,1055,,,
5501722750,517,0,517,,,
5501724375,263,0,263,,,
5501729700,10,0,10,,,
5501729700,453,0,453,,,
5501732125,111,0,111,,,
5501736000,494,0,494,,,
5501740900,4094,0,4094,,,
5501741525,3917,0,3917,,,
5501741550,687,0,687,,,
5501756350,278,0,278,,,
5501769975,289,0,289,,,
5501771275,555,0,555,,,
5501773875,565,0,565,,,
5501776625,1134,0,1134,,,
5501779875,980,0,980,,,
5501786537,1826,0,1826,,,
5501788875,622,0,622,,,
5501900100,844,0,844,,,
5501905750,324,0,324,,,
5501911425,52,0,52,,,
5501916150,647,0,647,,,
5501916175,333,0,333,,,
5501918125,71,0,71,,,
5501920025,244,0,244,,,
5501920450,391,0,391,,,
5501922250,284,0,284,,,
5501926775,87,0,87,,,
5501927775,634,0,634,,,
5501930275,445,0,445,,,
5501930425,214,0,214,,,
5501931275,296,0,296,,,
5501931575,647,0,647,,,
5501933900,268,0,268,,,
5501934200,199,0,199,,,
5501935050,285,0,285,,,
5501935125,301,0,301,,,
5501943700,304,0,304,,,
5501945700,282,0,282,,,
5501946075,743,0,743,,,
5501946100,331,0,331,,,
5501946625,332,0,332,,,
5501950175,429,0,429,,,
5501950275,175,0,175,,,
5501951125,324,0,324,,,
5501955800,183,0,183,,,
5501955800,223,0,223,,,
5501955800,257,0,257,,,
5501955800,364,0,364,,,
5501955800,381,0,381,,,
5501960825,518,0,518,,,
5501963000,965,0,965,,,
5501967025,232,0,232,,,
5501972450,134,0,134,,,
5501973350,428,0,428,,,
5501973550,162,0,162,,,
5501976625,2,0,2,,,
5501979625,999,0,999,,,
5501979650,381,0,381,,,
5501981825,376,0,376,,,
5501981850,83,0,83,,,
5501983350,314,0,314,,,
5501983575,185,0,185,,,
5501985925,386,0,386,,,
5501988275,283,0,283,,,
5501988300,381,0,381,,,
5501989125,275,0,275,,,
5501989425,439,0,439,,,
5502102800,564,0,564,,,
5502102825,563,0,563,,,
5502111900,999,0,999,,,
5502112200,463,0,463,,,
5502116450,0,0,0,,,
5502116450,3435,0,3435,,,
5502116475,446,0,446,,,
5502117325,293,0,293,,,
5502119375,1703,0,1703,,,
5502120775,170,0,170,,,
5502125150,1000,0,1000,,,
5502126725,635,0,635,,,
5502126875,617,0,617,,,
5502128000,202,0,202,,,
5502132375,403,0,403,,,
5502143125,577,0,577,,,
5502143775,805,0,805,,,
5502145350,1818,0,1818,,,
5502145375,2352,0,2352,,,
5502146050,729,0,729,,,
5502149150,639,0,639,,,
5502157025,464,0,464,,,
5502160687,461,0,461,,,
5502160925,1891,0,1891,,,
5502161100,1359,0,1359,,,
5502164100,1718,0,1718,,,
5502164100,1729,0,1729,,,
5502164100,1786,0,1786,,,
5502164900,1588,0,1588,,,
5502166150,291,0,291,,,
5502166175,495,0,495,,,
5502168100,673,0,673,,,
5502172250,431,0,431,,,
5502176225,353,0,353,,,
5502186100,1461,0,1461,,,
5502188150,1425,0,1425,,,
5502189300,429,0,429,,,
5502189325,1120,0,1120,,,
5502306225,60,0,60,,,
5502309550,716,0,716,,,
5502315075,571,0,571,,,
5502319850,63,0,63,,,
5502321900,224,0,224,,,
5502321925,468,0,468,,,
5502325725,134,0,134,,,
5502327700,457,0,457,,,
5502328450,332,0,332,,,
5502332500,204,0,204,,,
5502346675,89,0,89,,,
5502349275,316,0,316,,,
5502354900,109,0,109,,,
5502365050,453,0,453,,,
5502365050,477,0,477,,,
5502365050,501,0,501,,,
5502365050,528,0,528,,,
5502365050,533,0,533,,,
5502365050,580,0,580,,,
5502365075,561,0,561,,,
5502372275,313,0,313,,,
5502372500,564,0,564,,,
5502374550,321,0,321,,,
5502377175,78,0,78,,,
5502382100,412,0,412,,,
5502384725,361,0,361,,,
5502384750,263,0,263,,,
5502500875,1333,0,1333,,,
5502506300,1266,0,1266,,,
5502507025,876,0,876,,,
5502507800,996,0,996,,,
5502507825,402,0,402,,,
5502508350,1358,0,1358,,,
5502508475,620,0,620,,,
5502508500,670,0,670,,,
5502509775,2726,0,2726,,,
5502510075,643,0,643,,,
5502511150,2301,0,2301,,,
5502512225,1016,0,1016,,,
5502514650,881,0,881,,,
5502517175,4447,0,4447,,,
5502517200,1067,0,1067,,,
5502517200,1785,0,1785,,,
5502517775,2715,0,2715,,,
5502517800,0,0,0,,,
5502517800,1126,0,1126,,,
5502518700,675,0,675,,,
5502518725,624,0,624,,,
5502519250,1556,0,1556,,,
5502519275,1090,0,1090,,,
5502519350,0,0,0,,,
5502519350,0,0,0,,,
5502519350,494,0,494,,,
5502519350,604,0,604,,,
5502519350,2309,0,2309,,,
5502519350,2656,0,2656,,,
5502521100,502,0,502,,,
5502521100,943,0,943,,,
5502521125,3854,0,3854,,,
5502522575,60,0,60,,,
5502525950,897,0,897,,,
5502525950,1383,0,1383,,,
5502525950,2895,0,2895,,,
5502525950,3090,0,3090,,,
5502525950,3369,0,3369,,,
5502525950,5352,0,5352,,,
5502546850,5907,0,5907,,,
5502548000,0,0,0,,,
5502548000,0,0,0,,,
5502548000,0,0,0,,,
5502548000,0,0,0,,,
5502548000,0,0,0,,,
5502548000,0,0,0,,,
5502548000,0,0,0,,,
5502548000,0,0,0,,,
5502548000,0,0,0,,,
5502548000,0,0,0,,,
5502548000,0,0,0,,,
5502548000,1,0,1,,,
5502548000,2,0,2,,,
5502548000,3,0,3,,,
5502548000,21,0,21,,,
5502548000,211,0,211,,,
5502548000,219,0,219,,,
5502548000,459,0,459,,,
5502548000,546,0,546,,,
5502548000,557,0,557,,,
5502548000,607,0,607,,,
5502548000,651,0,651,,,
5502548000,652,0,652,,,
5502548000,789,0,789,,,
5502548000,808,0,808,,,
5502548000,820,0,820,,,
5502548000,848,0,848,,,
5502548000,863,0,863,,,
5502548000,867,0,867,,,
5502548000,871,0,871,,,
5502548000,891,0,891,,,
5502548000,906,0,906,,,
5502548000,925,0,925,,,
5502548000,936,0,936,,,
5502548000,950,0,950,,,
5502548000,951,0,951,,,
5502548000,977,0,977,,,
5502548000,987,0,987,,,
5502548000,1003,0,1003,,,
5502548000,1051,0,1051,,,
5502548000,1064,0,1064,,,
5502548000,1069,0,1069,,,
5502548000,1081,0,1081,,,
5502548000,1098,0,1098,,,
5502548000,1115,0,1115,,,
5502548000,1117,0,1117,,,
5502548000,1165,0,1165,,,
5502548000,1235,0,1235,,,
5502548000,1254,0,1254,,,
5502548000,1259,0,1259,,,
5502548000,1262,0,1262,,,
5502548000,1266,0,1266,,,
5502548000,1266,0,1266,,,
5502548000,1323,0,1323,,,
5502548000,1329,0,1329,,,
5502548000,1346,0,1346,,,
5502548000,1359,0,1359,,,
5502548000,1398,0,1398,,,
5502548000,1446,0,1446,,,
5502548000,1454,0,1454,,,
5502548000,1460,0,1460,,,
5502548000,1473,0,1473,,,
5502548000,1495,0,1495,,,
5502548000,1511,0,1511,,,
5502548000,1565,0,1565,,,
5502548000,1594,0,1594,,,
5502548000,1678,0,1678,,,
5502548000,1688,0,1688,,,
5502548000,1696,0,1696,,,
5502548000,1701,0,1701,,,
5502548000,1705,0,1705,,,
5502548000,1710,0,1710,,,
5502548000,1751,0,1751,,,
5502548000,1809,0,1809,,,
5502548000,1811,0,1811,,,
5502548000,1844,0,1844,,,
5502548000,1856,0,1856,,,
5502548000,1879,0,1879,,,
5502548000,1884,0,1884,,,
5502548000,1941,0,1941,,,
5502548000,2028,0,2028,,,
5502548000,2036,0,2036,,,
5502548000,2074,0,2074,,,
5502548000,2080,0,2080,,,
5502548000,2090,0,2090,,,
5502548000,2097,0,2097,,,
5502548000,2100,0,2100,,,
5502548000,2186,0,2186,,,
5502548000,2198,0,2198,,,
5502548000,2211,0,2211,,,
5502548000,2239,0,2239,,,
5502548000,2264,0,2264,,,
5502548000,2269,0,2269,,,
5502548000,2276,0,2276,,,
5502548000,2301,0,2301,,,
5502548000,2338,0,2338,,,
5502548000,2353,0,2353,,,
5502548000,2354,0,2354,,,
5502548000,2384,0,2384,,,
5502548000,2384,0,2384,,,
5502548000,2453,0,2453,,,
5502548000,2522,0,2522,,,
5502548000,2542,0,2542,,,
5502548000,2570,0,2570,,,
5502548000,2647,0,2647,,,
5502548000,2742,0,2742,,,
5502548000,2844,0,2844,,,
5502548000,2900,0,2900,,,
5502548000,2916,0,2916,,,
5502548000,3059,0,3059,,,
5502548000,3066,0,3066,,,
5502548000,3140,0,3140,,,
5502548000,3152,0,3152,,,
5502548000,3159,0,3159,,,
5502548000,3209,0,3209,,,
5502548000,3416,0,3416,,,
5502548000,3510,0,3510,,,
5502548000,3583,0,3583,,,
5502548000,3660,0,3660,,,
5502548000,3676,0,3676,,,
5502548000,3862,0,3862,,,
5502548000,3965,0,3965,,,
5502548000,3975,0,3975,,,
5502548000,4212,0,4212,,,
5502548000,4865,0,4865,,,
5502548025,566,0,566,,,
5502548025,2960,0,2960,,,
5502548750,1190,0,1190,,,
5502549575,2607,0,2607,,,
5502550225,1212,0,1212,,,
5502550250,802,0,802,,,
5502550475,910,0,910,,,
5502551575,0,0,0,,,
5502551575,4036,0,4036,,,
5502551575,4953,0,4953,,,
5502551575,5547,0,5547,,,
5502551600,4642,0,4642,,,
5502553675,3147,0,3147,,,
5502553675,3418,0,3418,,,
5502554100,813,0,813,,,
5502554725,2413,0,2413,,,
5502554725,2527,0,2527,,,
5502560200,6661,0,6661,,,
5502560200,6695,0,6695,,,
5502560200,6755,0,6755,,,
5502560225,2459,0,2459,,,
5502562050,575,0,575,,,
5502563375,2438,0,2438,,,
5502565575,518,0,518,,,
5502568725,142,0,142,,,
5502569850,1226,0,1226,,,
5502570400,1490,0,1490,,,
5502573750,1573,0,1573,,,
5502575850,1450,0,1450,,,
5502575875,1934,0,1934,,,
5502577675,4,0,4,,,
5502577675,2209,0,2209,,,
5502577675,2250,0,2250,,,
5502577675,2270,0,2270,,,
5502577675,2317,0,2317,,,
5502578600,0,0,0,,,
5502578600,5000,0,5000,,,
5502578600,5001,0,5001,,,
5502578600,5120,0,5120,,,
5502578600,5156,0,5156,,,
5502578625,1588,0,1588,,,
5502582525,62026,0,62026,,,
5502582600,1436,0,1436,,,
5502582600,2654,0,2654,,,
5502582600,4412,0,4412,,,
5502582625,532,0,532,,,
5502582625,1065,0,1065,,,
5502582750,1073,0,1073,,,
5502584350,4310,0,4310,,,
5502584350,4355,0,4355,,,
5502586125,3222,0,3222,,,
5502587750,521,0,521,,,
5502587750,1511,0,1511,,,
5502587750,2714,0,2714,,,
5502589450,471,0,471,,,
5502703200,1829,0,1829,,,
5502705900,1046,0,1046,,,
5502705900,1118,0,1118,,,
5502705900,1371,0,1371,,,
5502705900,1652,0,1652,,,
5502705900,1858,0,1858,,,
5502705900,1927,0,1927,,,
5502705925,1084,0,1084,,,
5502705925,1429,0,1429,,,
5502710450,380,0,380,,,
5502711275,636,0,636,,,
5502711850,615,0,615,,,
5502714300,449,0,449,,,
5502715900,241,0,241,,,
5502715925,527,0,527,,,
5502716450,0,0,0,,,
5502723000,706,0,706,,,
5502724000,910,0,910,,,
5502727000,983,0,983,,,
5502727025,600,0,600,,,
5502733000,0,0,0,,,
5502734000,838,0,838,,,
5502735750,2227,0,2227,,,
5502736100,0,0,0,,,
5502736100,1222,0,1222,,,
5502736625,756,0,756,,,
5502736650,975,0,975,,,
5502737150,619,0,619,,,
5502738675,1256,0,1256,,,
5502738900,113,0,113,,,
5502743050,1114,0,1114,,,
5502743650,642,0,642,,,
5502745475,1522,0,1522,,,
5502745500,3,0,3,,,
5502745500,747,0,747,,,
5502745950,202,0,202,,,
5502745975,330,0,330,,,
5502745975,390,0,390,,,
5502750200,3243,0,3243,,,
5502756075,389,0,389,,,
5502759000,0,0,0,,,
5502759000,683,0,683,,,
5502764375,694,0,694,,,
5502766150,764,0,764,,,
5502766900,408,0,408,,,
5502769962,1564,0,1564,,,
5502773575,21,0,21,,,
5502779375,840,0,840,,,
5502779425,300,0,300,,,
5502779425,430,0,430,,,
5502780525,870,0,870,,,
5502783975,420,0,420,,,
5502783975,1439,0,1439,,,
5502783975,1480,0,1480,,,
5502783975,1579,0,1579,,,
5502784425,2983,0,2983,,,
5502785650,0,0,0,,,
5502785650,14,0,14,,,
5502785650,877,0,877,,,
5502787225,521,0,521,,,
5502904325,934,0,934,,,
5502910700,704,0,704,,,
5502915025,289,0,289,,,
5502922850,240,0,240,,,
5502922875,1041,0,1041,,,
5502924150,299,0,299,,,
5502926625,308,0,308,,,
5502926650,695,0,695,,,
5502928300,893,0,893,,,
5502928950,938,0,938,,,
5502937750,634,0,634,,,
5502943925,1685,0,1685,,,
5502955500,1441,0,1441,,,
5502972600,2134,0,2134,,,
5502974225,731,0,731,,,
5502977875,1602,0,1602,,,
5502977875,1627,0,1627,,,
5502977875,2596,0,2596,,,
5502977900,587,0,587,,,
5502981525,712,0,712,,,
5502983600,685,0,685,,,
5503101825,766,0,766,,,
5503106775,416,0,416,,,
5503110575,466,0,466,,,
5503115825,165,0,165,,,
5503118425,135,0,135,,,
5503129925,541,0,541,,,
5503133350,733,0,733,,,
5503134425,225,0,225,,,
5503141725,897,0,897,,,
5503141800,466,0,466,,,
5503148725,470,0,470,,,
5503159100,786,0,786,,,
5503159800,296,0,296,,,
5503161250,810,0,810,,,
5503163975,430,0,430,,,
5503174575,454,0,454,,,
5503174600,689,0,689,,,
5503178275,733,0,733,,,
5503178650,2378,0,2378,,,
5503178650,3211,0,3211,,,
5503178650,3273,0,3273,,,
5503178650,3308,0,3308,,,
5503178650,3320,0,3320,,,
5503178660,471,0,471,,,
5503178675,1525,0,1525,,,
5503183512,618,0,618,,,
5503309050,573,0,573,,,
5503316275,648,0,648,,,
5503316300,705,0,705,,,
5503320675,125,0,125,,,
5503321150,906,0,906,,,
5503322375,523,0,523,,,
5503323325,473,0,473,,,
5503323350,1049,0,1049,,,
5503330300,278,0,278,,,
5503333400,359,0,359,,,
5503339975,271,0,271,,,
5503346175,492,0,492,,,
5503351025,825,0,825,,,
5503351025,1642,0,1642,,,
5503351025,1746,0,1746,,,
5503351025,1850,0,1850,,,
5503351025,1858,0,1858,,,
5503351025,1907,0,1907,,,
5503351050,2088,0,2088,,,
5503356775,397,0,397,,,
5503360725,299,0,299,,,
5503362125,129,0,129,,,
5503366550,1453,0,1453,,,
5503367800,117,0,117,,,
5503368700,471,0,471,,,
5503371425,348,0,348,,,
5503373300,286,0,286,,,
5503373375,581,0,581,,,
5503375750,1041,0,1041,,,
5503376650,480,0,480,,,
5503378975,1695,0,1695,,,
5503379775,405,0,405,,,
5503385975,354,0,354,,,
5503386575,177,0,177,,,
5503387375,292,0,292,,,
5503501550,4431,0,4431,,,
5503503825,782,0,782,,,
5503509500,682,0,682,,,
5503510625,1199,0,1199,,,
5503515200,504,0,504,,,
5503520800,502,0,502,,,
5503522300,0,0,0,,,
5503522300,0,0,0,,,
5503522300,0,0,0,,,
5503522300,0,0,0,,,
5503522300,0,0,0,,,
5503522300,0,0,0,,,
5503522300,1,0,1,,,
5503522300,1,0,1,,,
5503522300,1,0,1,,,
5503522300,2,0,2,,,
5503522300,4,0,4,,,
5503522300,5,0,5,,,
5503522300,81,0,81,,,
5503522300,176,0,176,,,
5503522300,307,0,307,,,
5503522300,351,0,351,,,
5503522300,354,0,354,,,
5503522300,370,0,370,,,
5503522300,375,0,375,,,
5503522300,396,0,396,,,
5503522300,444,0,444,,,
5503522300,448,0,448,,,
5503522300,463,0,463,,,
5503522300,463,0,463,,,
5503522300,481,0,481,,,
5503522300,501,0,501,,,
5503522300,503,0,503,,,
5503522300,504,0,504,,,
5503522300,533,0,533,,,
5503522300,550,0,550,,,
5503522300,610,0,610,,,
5503522300,632,0,632,,,
5503522300,672,0,672,,,
5503522300,755,0,755,,,
5503522300,798,0,798,,,
5503522300,921,0,921,,,
5503522300,929,0,929,,,
5503522300,1017,0,1017,,,
5503522300,1061,0,1061,,,
5503522300,1160,0,1160,,,
5503522300,1160,0,1160,,,
5503522300,1179,0,1179,,,
5503522300,1193,0,1193,,,
5503522300,1232,0,1232,,,
5503522300,1242,0,1242,,,
5503522300,1285,0,1285,,,
5503522300,1390,0,1390,,,
5503522300,1414,0,1414,,,
5503522300,1416,0,1416,,,
5503522300,1438,0,1438,,,
5503522300,1504,0,1504,,,
5503522300,1534,0,1534,,,
5503522300,1551,0,1551,,,
5503522300,1653,0,1653,,,
5503522300,1671,0,1671,,,
5503522300,1909,0,1909,,,
5503522300,2382,0,2382,,,
5503522300,3370,0,3370,,,
5503524825,261,0,261,,,
5503524850,174,0,174,,,
5503525125,988,0,988,,,
5503544350,707,0,707,,,
5503546275,677,0,677,,,
5503560750,295,0,295,,,
5503563400,2409,0,2409,,,
5503572675,2223,0,2223,,,
5503581550,1698,0,1698,,,
5503583612,5077,0,5077,,,
5503587400,246,0,246,,,
5503703875,619,0,619,,,
5503716550,276,0,276,,,
5503725575,146,0,146,,,
5503725675,132,0,132,,,
5503726200,1410,0,1410,,,
5503735600,265,0,265,,,
5503745625,126,0,126,,,
5503779975,112,0,112,,,
5503901525,719,0,719,,,
5503903150,1180,0,1180,,,
5503903750,1653,0,1653,,,
5503909300,574,0,574,,,
5503911600,1187,0,1187,,,
5503912075,404,0,404,,,
5503912075,585,0,585,,,
5503912325,1186,0,1186,,,
5503922475,505,0,505,,,
5503922500,720,0,720,,,
5503923150,960,0,960,,,
5503924050,2053,0,2053,,,
5503925075,214,0,214,,,
5503926275,0,0,0,,,
5503926275,0,0,0,,,
5503926275,2,0,2,,,
5503926275,74,0,74,,,
5503926275,245,0,245,,,
5503926275,674,0,674,,,
5503926275,752,0,752,,,
5503926275,787,0,787,,,
5503926275,860,0,860,,,
5503926275,862,0,862,,,
5503926275,868,0,868,,,
5503926275,871,0,871,,,
5503926275,946,0,946,,,
5503926275,965,0,965,,,
5503926275,1029,0,1029,,,
5503926275,1077,0,1077,,,
5503926275,1148,0,1148,,,
5503926275,1153,0,1153,,,
5503926275,1181,0,1181,,,
5503926275,1185,0,1185,,,
5503926275,1202,0,1202,,,
5503926275,1255,0,1255,,,
5503926275,1273,0,1273,,,
5503926275,1281,0,1281,,,
5503926275,1296,0,1296,,,
5503926275,1311,0,1311,,,
5503926275,1503,0,1503,,,
5503926300,0,0,0,,,
5503926300,2250,0,2250,,,
5503926450,765,0,765,,,
5503927975,1680,0,1680,,,
5503939300,0,0,0,,,
5503942125,1203,0,1203,,,
5503949650,759,0,759,,,
5503951450,468,0,468,,,
5503954650,353,0,353,,,
5503958000,2906,0,2906,,,
5503958900,769,0,769,,,
5503958925,471,0,471,,,
5503960425,1338,0,1338,,,
5503968175,1050,0,1050,,,
5503968175,1133,0,1133,,,
5503968175,1241,0,1241,,,
5503968175,1302,0,1302,,,
5503968200,942,0,942,,,
5503969525,682,0,682,,,
5503969550,468,0,468,,,
5503970500,351,0,351,,,
5503976250,454,0,454,,,
5503979125,3192,0,3192,,,
5503984425,0,0,0,,,
5503984425,2219,0,2219,,,
5503984450,984,0,984,,,
5504101625,129,0,129,,,
5504102625,363,0,363,,,
5504102950,282,0,282,,,
5504107950,129,0,129,,,
5504113125,66,0,66,,,
5504117425,1164,0,1164,,,
5504117450,433,0,433,,,
5504127600,280,0,280,,,
5504134650,298,0,298,,,
5504142500,787,0,787,,,
5504144375,662,0,662,,,
5504155575,245,0,245,,,
5504155575,253,0,253,,,
5504155575,280,0,280,,,
5504164050,27,0,27,,,
5504169625,98,0,98,,,
5504183025,638,0,638,,,
5504304250,222,0,222,,,
5504306100,386,0,386,,,
5504308375,423,0,423,,,
5504308400,225,0,225,,,
5504308525,245,0,245,,,
5504308850,1503,0,1503,,,
5504308875,220,0,220,,,
5504313050,513,0,513,,,
5504313075,246,0,246,,,
5504313100,160,0,160,,,
5504315500,178,0,178,,,
5504317950,1128,0,1128,,,
5504320175,662,0,662,,,
5504323400,369,0,369,,,
5504325600,1391,0,1391,,,
5504325625,289,0,289,,,
5504329525,241,0,241,,,
5504332825,311,0,311,,,
5504333500,632,0,632,,,
5504333525,742,0,742,,,
5504334300,192,0,192,,,
5504337800,1236,0,1236,,,
5504342250,2218,0,2218,,,
5504343825,309,0,309,,,
5504344050,457,0,457,,,
5504345025,157,0,157,,,
5504345325,386,0,386,,,
5504349350,279,0,279,,,
5504352150,109,0,109,,,
5504353950,339,0,339,,,
5504354675,85,0,85,,,
5504354700,126,0,126,,,
5504354775,295,0,295,,,
5504355200,653,0,653,,,
5504355225,378,0,378,,,
5504358125,305,0,305,,,
5504361150,440,0,440,,,
5504361425,89,0,89,,,
5504361450,196,0,196,,,
5504363250,1730,0,1730,,,
5504363250,1734,0,1734,,,
5504363250,1873,0,1873,,,
5504363250,2400,0,2400,,,
5504363275,978,0,978,,,
5504364625,452,0,452,,,
5504364650,514,0,514,,,
5504374450,569,0,569,,,
5504375075,417,0,417,,,
5504379250,212,0,212,,,
5504383900,329,0,329,,,
5504384075,182,0,182,,,
5504387800,188,0,188,,,
5504388825,69,0,69,,,
5504388850,87,0,87,,,
5504389250,223,0,223,,,
5504500325,345,0,345,,,
5504500750,610,0,610,,,
5504500775,747,0,747,,,
5504506300,358,0,358,,,
5504509925,1751,0,1751,,,
5504510075,316,0,316,,,
5504510100,794,0,794,,,
5504510475,153,0,153,,,
5504511725,530,0,530,,,
5504515000,707,0,707,,,
5504519075,1194,0,1194,,,
5504524725,1349,0,1349,,,
5504537875,734,0,734,,,
5504538550,392,0,392,,,
5504553750,6032,0,6032,,,
5504553775,833,0,833,,,
5504554000,796,0,796,,,
5504554850,393,0,393,,,
5504554850,393,0,393,,,
5504556700,1488,0,1488,,,
5504556725,933,0,933,,,
5504576075,568,0,568,,,
5504578875,621,0,621,,,
5504583625,533,0,533,,,
5504589475,647,0,647,,,
5504706925,2818,0,2818,,,
5504706950,789,0,789,,,
5504710125,1340,0,1340,,,
5504731300,737,0,737,,,
5504731350,902,0,902,,,
5504739750,223,0,223,,,
5504739775,366,0,366,,,
5504746875,372,0,372,,,
5504748400,478,0,478,,,
5504749450,911,0,911,,,
5504749500,106,0,106,,,
5504749525,357,0,357,,,
5504765600,757,0,757,,,
5504765625,987,0,987,,,
5504770925,257,0,257,,,
5504772525,262,0,262,,,
5504902550,571,0,571,,,
5504902575,1072,0,1072,,,
5504904025,341,0,341,,,
5504904775,725,0,725,,,
5504908125,118,0,118,,,
5504909600,718,0,718,,,
5504915875,221,0,221,,,
5504915975,303,0,303,,,
5504920350,2803,0,2803,,,
5504920375,1191,0,1191,,,
5504922525,240,0,240,,,
5504934450,485,0,485,,,
5504934475,487,0,487,,,
5504935400,209,0,209,,,
5504944625,262,0,262,,,
5504944650,495,0,495,,,
5504945325,4,0,4,,,
5504951725,356,0,356,,,
5504953100,1687,0,1687,,,
5504953125,610,0,610,,,
5504953950,61,0,61,,,
5504954425,418,0,418,,,
5504955200,29,0,29,,,
5504965700,215,0,215,,,
5504967100,139,0,139,,,
5504967875,409,0,409,,,
5504967900,423,0,423,,,
5504983150,311,0,311,,,
5504989350,242,0,242,,,
5505101925,58,0,58,,,
5505112525,126,0,126,,,
5505131875,111,0,111,,,
5505136525,173,0,173,,,
5505136525,214,0,214,,,
5505136525,235,0,235,,,
5505136525,250,0,250,,,
5505139625,364,0,364,,,
5505140075,156,0,156,,,
5505151200,1195,0,1195,,,
5505154075,520,0,520,,,
5505159850,253,0,253,,,
5505161825,147,0,147,,,
5505171875,247,0,247,,,
5505173400,254,0,254,,,
5505300350,950,0,950,,,
5505300900,755,0,755,,,
5505301275,202,0,202,,,
5505301275,394,0,394,,,
5505301300,295,0,295,,,
5505305550,90,0,90,,,
5505307900,381,0,381,,,
5505307900,528,0,528,,,
5505307900,534,0,534,,,
5505307900,608,0,608,,,
5505309900,1037,0,1037,,,
5505314800,124,0,124,,,
5505315375,318,0,318,,,
5505318075,191,0,191,,,
5505327225,251,0,251,,,
5505328250,285,0,285,,,
5505328325,382,0,382,,,
5505335075,303,0,303,,,
5505335100,387,0,387,,,
5505337275,437,0,437,,,
5505340000,200,0,200,,,
5505340325,181,0,181,,,
5505348425,477,0,477,,,
5505350750,354,0,354,,,
5505350775,255,0,255,,,
5505351300,291,0,291,,,
5505352050,128,0,128,,,
5505357775,305,0,305,,,
5505357975,421,0,421,,,
5505375900,278,0,278,,,
5505379150,232,0,232,,,
5505504125,977,0,977,,,
5505512225,54,0,54,,,
5505516225,544,0,544,,,
5505516650,1455,0,1455,,,
5505525300,1047,0,1047,,,
5505526675,725,0,725,,,
5505526675,859,0,859,,,
5505526675,907,0,907,,,
5505526675,907,0,907,,,
5505526675,913,0,913,,,
5505526675,936,0,936,,,
5505526675,1000,0,1000,,,
5505526675,1002,0,1002,,,
5505526675,1172,0,1172,,,
5505533700,744,0,744,,,
5505537600,3256,0,3256,,,
5505537900,0,0,0,,,
5505537900,4516,0,4516,,,
5505537925,1436,0,1436,,,
5505538350,1935,0,1935,,,
5505540375,312,0,312,,,
5505540375,2217,0,2217,,,
5505540750,0,0,0,,,
5505541675,4088,0,4088,,,
5505541700,1469,0,1469,,,
5505551850,733,0,733,,,
5505559125,2227,0,2227,,,
5505561025,1140,0,1140,,,
5505561050,881,0,881,,,
5505578175,441,0,441,,,
5505578200,1892,0,1892,,,
5505578475,600,0,600,,,
5505583925,1950,0,1950,,,
5505583950,610,0,610,,,
5505583975,448,0,448,,,
5505583975,1345,0,1345,,,
5505583975,1404,0,1404,,,
5505583975,1543,0,1543,,,
5505583975,1599,0,1599,,,
5505583975,1769,0,1769,,,
5505584000,1305,0,1305,,,
5505586925,700,0,700,,,
5505586925,1296,0,1296,,,
5505702850,412,0,412,,,
5505712350,333,0,333,,,
5505715225,97,0,97,,,
5505715225,314,0,314,,,
5505718225,224,0,224,,,
5505723800,715,0,715,,,
5505725850,72,0,72,,,
5505726825,395,0,395,,,
5505728850,399,0,399,,,
5505728850,532,0,532,,,
5505736675,117,0,117,,,
5505739575,409,0,409,,,
5505739800,23,0,23,,,
5505743300,934,0,934,,,
5505744675,490,0,490,,,
5505744825,5,0,5,,,
5505744825,544,0,544,,,
5505746525,767,0,767,,,
5505746600,268,0,268,,,
5505749375,294,0,294,,,
5505750025,1756,0,1756,,,
5505755700,486,0,486,,,
5505755725,1324,0,1324,,,
5505756900,755,0,755,,,
5505760150,338,0,338,,,
5505763650,425,0,425,,,
5505772625,245,0,245,,,
5505778300,442,0,442,,,
5505781725,132,0,132,,,
5505788150,0,0,0,,,
5505788500,404,0,404,,,
5505788525,392,0,392,,,
5505909635,1023,0,1023,,,
5505909800,1474,0,1474,,,
5505909800,1796,0,1796,,,
5505928675,2,0,2,,,
5505939225,0,0,0,,,
5505939225,0,0,0,,,
5505939225,1,0,1,,,
5505939225,2,0,2,,,
5505939225,4,0,4,,,
5505939225,8,0,8,,,
5505939225,27,0,27,,,
5505939225,28,0,28,,,
5505939225,32,0,32,,,
5505939225,47,0,47,,,
5505939225,65,0,65,,,
5505939225,80,0,80,,,
5505939225,208,0,208,,,
5505939225,229,0,229,,,
5505939225,234,0,234,,,
5505939225,256,0,256,,,
5505939225,260,0,260,,,
5505939225,273,0,273,,,
5505939225,317,0,317,,,
5505939225,334,0,334,,,
5505939225,335,0,335,,,
5505939225,342,0,342,,,
5505939225,346,0,346,,,
5505939225,379,0,379,,,
5505939225,393,0,393,,,
5505939225,401,0,401,,,
5505939225,403,0,403,,,
5505939225,407,0,407,,,
5505939225,407,0,407,,,
5505939225,432,0,432,,,
5505939225,433,0,433,,,
5505939225,435,0,435,,,
5505939225,440,0,440,,,
5505939225,442,0,442,,,
5505939225,444,0,444,,,
5505939225,452,0,452,,,
5505939225,471,0,471,,,
5505939225,473,0,473,,,
5505939225,474,0,474,,,
5505939225,497,0,497,,,
5505939225,498,0,498,,,
5505939225,513,0,513,,,
5505939225,523,0,523,,,
5505939225,537,0,537,,,
5505939225,538,0,538,,,
5505939225,539,0,539,,,
5505939225,558,0,558,,,
5505939225,560,0,560,,,
5505939225,566,0,566,,,
5505939225,568,0,568,,,
5505939225,578,0,578,,,
5505939225,583,0,583,,,
5505939225,585,0,585,,,
5505939225,589,0,589,,,
5505939225,621,0,621,,,
5505939225,652,0,652,,,
5505939225,657,0,657,,,
5505939225,682,0,682,,,
5505939225,699,0,699,,,
5505939225,735,0,735,,,
5505939225,753,0,753,,,
5505939225,766,0,766,,,
5505939225,773,0,773,,,
5505939225,774,0,774,,,
5505939225,788,0,788,,,
5505939225,796,0,796,,,
5505939225,796,0,796,,,
5505939225,807,0,807,,,
5505939225,812,0,812,,,
5505939225,820,0,820,,,
5505939225,843,0,843,,,
5505939225,862,0,862,,,
5505939225,864,0,864,,,
5505939225,890,0,890,,,
5505939225,894,0,894,,,
5505939225,920,0,920,,,
5505939225,937,0,937,,,
5505939225,943,0,943,,,
5505939225,948,0,948,,,
5505939225,949,0,949,,,
5505939225,960,0,960,,,
5505939225,970,0,970,,,
5505939225,994,0,994,,,
5505939225,1004,0,1004,,,
5505939225,1058,0,1058,,,
5505939225,1065,0,1065,,,
5505939225,1178,0,1178,,,
5505939225,1201,0,1201,,,
5505939225,1227,0,1227,,,
5505939225,1403,0,1403,,,
5505939225,1669,0,1669,,,
5505960975,1856,0,1856,,,
5505961175,1100,0,1100,,,
5505963300,1657,0,1657,,,
5505963300,2079,0,2079,,,
5505963300,2860,0,2860,,,
5505963300,2976,0,2976,,,
5505963300,3147,0,3147,,,
5505966125,2008,0,2008,,,
5505971125,3080,0,3080,,,
5505971125,3954,0,3954,,,
5505974025,1575,0,1575,,,
5505974650,520,0,520,,,
5505974650,827,0,827,,,
5505974650,1012,0,1012,,,
5505974650,1826,0,1826,,,
5505974650,1877,0,1877,,,
5505981250,3207,0,3207,,,
5505986500,2121,0,2121,,,
5506100600,586,0,586,,,
5506101000,1855,0,1855,,,
5506112575,687,0,687,,,
5506112850,309,0,309,,,
5506112875,749,0,749,,,
5506127250,632,0,632,,,
5506139350,1741,0,1741,,,
5506144425,561,0,561,,,
5506146400,1548,0,1548,,,
5506146425,980,0,980,,,
5506154050,890,0,890,,,
5506162625,545,0,545,,,
5506166700,941,0,941,,,
5506185775,825,0,825,,,
5506304550,888,0,888,,,
5506304575,349,0,349,,,
5506304825,843,0,843,,,
5506311300,679,0,679,,,
5506312300,3001,0,3001,,,
5506325325,1253,0,1253,,,
5506331150,1364,0,1364,,,
5506332275,1726,0,1726,,,
5506335350,2704,0,2704,,,
5506335450,5727,0,5727,,,
5506340775,0,0,0,,,
5506340775,470,0,470,,,
5506340775,522,0,522,,,
5506340775,562,0,562,,,
5506340775,568,0,568,,,
5506340775,602,0,602,,,
5506340775,605,0,605,,,
5506340775,636,0,636,,,
5506340775,710,0,710,,,
5506340775,734,0,734,,,
5506340775,745,0,745,,,
5506340775,761,0,761,,,
5506340775,817,0,817,,,
5506340775,907,0,907,,,
5506340775,931,0,931,,,
5506340775,955,0,955,,,
5506340775,974,0,974,,,
5506340775,1084,0,1084,,,
5506340775,1189,0,1189,,,
5506340775,1259,0,1259,,,
5506340775,1313,0,1313,,,
5506340775,1559,0,1559,,,
5506340775,1758,0,1758,,,
5506340775,1908,0,1908,,,
5506340775,1933,0,1933,,,
5506340775,2045,0,2045,,,
5506340775,2279,0,2279,,,
5506340775,2412,0,2412,,,
5506340775,2622,0,2622,,,
5506340775,3556,0,3556,,,
5506350400,1141,0,1141,,,
5506359925,3706,0,3706,,,
5506359925,3909,0,3909,,,
5506359925,4175,0,4175,,,
5506359950,3977,0,3977,,,
5506368900,343,0,343,,,
5506373125,1381,0,1381,,,
5506373125,2146,0,2146,,,
5506383650,374,0,374,,,
5506386275,3002,0,3002,,,
5506502650,467,0,467,,,
5506502675,301,0,301,,,
5506506425,551,0,551,,,
5506506450,378,0,378,,,
5506506825,599,0,599,,,
5506506850,299,0,299,,,
5506508100,194,0,194,,,
5506508125,398,0,398,,,
5506517950,153,0,153,,,
5506518875,1265,0,1265,,,
5506518900,589,0,589,,,
5506523262,252,0,252,,,
5506525475,220,0,220,,,
5506530575,141,0,141,,,
5506530600,351,0,351,,,
5506533500,11,0,11,,,
5506539125,238,0,238,,,
5506542175,207,0,207,,,
5506554025,76,0,76,,,
5506556625,319,0,319,,,
5506572700,200,0,200,,,
5506573825,714,0,714,,,
5506573850,210,0,210,,,
5506575275,257,0,257,,,
5506584850,287,0,287,,,
5506586800,75,0,75,,,
5506587275,462,0,462,,,
5506588050,551,0,551,,,
5506700225,335,0,335,,,
5506700625,344,0,344,,,
5506702250,388,0,388,,,
5506702250,406,0,406,,,
5506702250,426,0,426,,,
5506702250,432,0,432,,,
5506702250,442,0,442,,,
5506702250,444,0,444,,,
5506702250,468,0,468,,,
5506702250,506,0,506,,,
5506702250,573,0,573,,,
5506702275,937,0,937,,,
5506723050,913,0,913,,,
5506724575,352,0,352,,,
5506742425,333,0,333,,,
5506756200,627,0,627,,,
5506758700,602,0,602,,,
5506761375,67,0,67,,,
5506761525,204,0,204,,,
5506763825,707,0,707,,,
5506765550,153,0,153,,,
5506769175,909,0,909,,,
5506778325,118,0,118,,,
5506781950,584,0,584,,,
5506782825,159,0,159,,,
5506786750,224,0,224,,,
5506788450,594,0,594,,,
5506907500,297,0,297,,,
5506909225,1802,0,1802,,,
5506917125,508,0,508,,,
5506932650,272,0,272,,,
5506932875,632,0,632,,,
5506939675,681,0,681,,,
5506951250,587,0,587,,,
5506951250,597,0,597,,,
5506951250,621,0,621,,,
5506951250,626,0,626,,,
5506951250,683,0,683,,,
5506951250,689,0,689,,,
5506951250,707,0,707,,,
5506951250,761,0,761,,,
5506951275,1811,0,1811,,,
5506962950,1318,0,1318,,,
5506968825,424,0,424,,,
5506970325,406,0,406,,,
5506972100,554,0,554,,,
5506972300,907,0,907,,,
5506974250,314,0,314,,,
5506974725,91,0,91,,,
5506980125,600,0,600,,,
5506980125,687,0,687,,,
5506980125,790,0,790,,,
5506980150,291,0,291,,,
5506987425,233,0,233,,,
5507113237,1138,0,1138,,,
5507113750,449,0,449,,,
5507115400,930,0,930,,,
5507116950,889,0,889,,,
5507122275,572,0,572,,,
5507127125,441,0,441,,,
5507127275,805,0,805,,,
5507128975,921,0,921,,,
5507139000,212,0,212,,,
5507139525,2235,0,2235,,,
5507140425,1391,0,1391,,,
5507143850,839,0,839,,,
5507148500,1236,0,1236,,,
5507148500,1768,0,1768,,,
5507148500,1784,0,1784,,,
5507148500,1861,0,1861,,,
5507148500,1864,0,1864,,,
5507148500,1870,0,1870,,,
5507148500,1963,0,1963,,,
5507148500,2202,0,2202,,,
5507148500,2352,0,2352,,,
5507148500,2397,0,2397,,,
5507148525,693,0,693,,,
5507148575,1761,0,1761,,,
5507148875,538,0,538,,,
5507149250,207,0,207,,,
5507150625,320,0,320,,,
5507150625,425,0,425,,,
5507153325,901,0,901,,,
5507153350,787,0,787,,,
5507157200,1541,0,1541,,,
5507166875,696,0,696,,,
5507168925,624,0,624,,,
5507171025,431,0,431,,,
5507172075,1376,0,1376,,,
5507181300,281,0,281,,,
5507181325,1388,0,1388,,,
5507181325,1504,0,1504,,,
5507181325,1505,0,1505,,,
5507181325,2106,0,2106,,,
5507181350,1184,0,1184,,,
5507182200,604,0,604,,,
5507186775,484,0,484,,,
5507300100,0,0,0,,,
5507300100,176,0,176,,,
5507303550,699,0,699,,,
5507306875,493,0,493,,,
5507306975,633,0,633,,,
5507307000,294,0,294,,,
5507307125,735,0,735,,,
5507307600,15,0,15,,,
5507309650,302,0,302,,,
5507309975,185,0,185,,,
5507312975,598,0,598,,,
5507315425,910,0,910,,,
5507316150,271,0,271,,,
5507318950,696,0,696,,,
5507320450,0,0,0,,,
5507320450,2,0,2,,,
5507322025,810,0,810,,,
5507322425,449,0,449,,,
5507322550,948,0,948,,,
5507323075,89,0,89,,,
5507323100,381,0,381,,,
5507324025,601,0,601,,,
5507325650,106,0,106,,,
5507327150,396,0,396,,,
5507327450,345,0,345,,,
5507331450,373,0,373,,,
5507331800,231,0,231,,,
5507332150,358,0,358,,,
5507332200,527,0,527,,,
5507332900,215,0,215,,,
5507333175,341,0,341,,,
5507334225,417,0,417,,,
5507335500,472,0,472,,,
5507336325,354,0,354,,,
5507338300,460,0,460,,,
5507340150,1335,0,1335,,,
5507340550,2194,0,2194,,,
5507340550,2293,0,2293,,,
5507346975,1445,0,1445,,,
5507348225,1689,0,1689,,,
5507349075,740,0,740,,,
5507349100,958,0,958,,,
5507349675,431,0,431,,,
5507354500,1376,0,1376,,,
5507354500,1387,0,1387,,,
5507354525,1423,0,1423,,,
5507357600,630,0,630,,,
5507363500,399,0,399,,,
5507366950,766,0,766,,,
5507367250,661,0,661,,,
5507367325,5104,0,5104,,,
5507367950,589,0,589,,,
5507368075,1207,0,1207,,,
5507369725,1123,0,1123,,,
5507369725,1221,0,1221,,,
5507369725,1291,0,1291,,,
5507372150,1395,0,1395,,,
5507375400,1102,0,1102,,,
5507375425,887,0,887,,,
5507377150,367,0,367,,,
5507377150,1419,0,1419,,,
5507377750,935,0,935,,,
5507379350,1138,0,1138,,,
5507381850,128,0,128,,,
5507384475,0,0,0,,,
5507384475,0,0,0,,,
5507384475,0,0,0,,,
5507384475,0,0,0,,,
5507384475,0,0,0,,,
5507384475,0,0,0,,,
5507384475,1,0,1,,,
5507384475,1,0,1,,,
5507384475,2,0,2,,,
5507384475,3,0,3,,,
5507384475,212,0,212,,,
5507384475,269,0,269,,,
5507384475,307,0,307,,,
5507384475,644,0,644,,,
5507384475,653,0,653,,,
5507384475,655,0,655,,,
5507384475,797,0,797,,,
5507384475,837,0,837,,,
5507384475,914,0,914,,,
5507384475,916,0,916,,,
5507384475,916,0,916,,,
5507384475,926,0,926,,,
5507384475,937,0,937,,,
5507384475,945,0,945,,,
5507384475,1000,0,1000,,,
5507384475,1044,0,1044,,,
5507384475,1055,0,1055,,,
5507384475,1064,0,1064,,,
5507384475,1091,0,1091,,,
5507384475,1109,0,1109,,,
5507384475,1133,0,1133,,,
5507384475,1153,0,1153,,,
5507384475,1157,0,1157,,,
5507384475,1236,0,1236,,,
5507384475,1448,0,1448,,,
5507384500,1549,0,1549,,,
5507386025,1741,0,1741,,,
5507386025,2137,0,2137,,,
5507386025,2768,0,2768,,,
5507386025,4128,0,4128,,,
5507386050,395,0,395,,,
5507387025,481,0,481,,,
5507501675,553,0,553,,,
5507503525,438,0,438,,,
5507505800,796,0,796,,,
5507506000,459,0,459,,,
5507516250,424,0,424,,,
5507517725,607,0,607,,,
5507521000,766,0,766,,,
5507529775,373,0,373,,,
5507531725,1044,0,1044,,,
5507541075,712,0,712,,,
5507549300,1616,0,1616,,,
5507549300,2060,0,2060,,,
5507549300,2098,0,2098,,,
5507551537,549,0,549,,,
5507557325,544,0,544,,,
5507557350,594,0,594,,,
5507561775,600,0,600,,,
5507562175,1742,0,1742,,,
5507562200,690,0,690,,,
5507562200,747,0,747,,,
5507562200,966,0,966,,,
5507564275,1191,0,1191,,,
5507564750,189,0,189,,,
5507564775,838,0,838,,,
5507573975,365,0,365,,,
5507577000,855,0,855,,,
5507577000,1314,0,1314,,,
5507583050,459,0,459,,,
5507584525,253,0,253,,,
5507584550,719,0,719,,,
5507711050,684,0,684,,,
5507717900,359,0,359,,,
5507720525,587,0,587,,,
5507724075,274,0,274,,,
5507732775,570,0,570,,,
5507750350,437,0,437,,,
5507753875,837,0,837,,,
5507753900,730,0,730,,,
5507754600,312,0,312,,,
5507756125,278,0,278,,,
5507756150,404,0,404,,,
5507757225,287,0,287,,,
5507760875,312,0,312,,,
5507760900,587,0,587,,,
5507760962,866,0,866,,,
5507773600,371,0,371,,,
5507775925,521,0,521,,,
5507785575,623,0,623,,,
5507785600,552,0,552,,,
5507850975,407,0,407,,,
5507850975,1485,0,1485,,,
5507905450,79,0,79,,,
5507905450,749,0,749,,,
5507905450,1194,0,1194,,,
5507905450,1334,0,1334,,,
5507910375,2763,0,2763,,,
5507910375,2847,0,2847,,,
5507910375,2976,0,2976,,,
5507917975,888,0,888,,,
5507917975,1038,0,1038,,,
5507917975,1411,0,1411,,,
5507917975,1608,0,1608,,,
5507917975,1924,0,1924,,,
5507917975,2145,0,2145,,,
5507917975,2454,0,2454,,,
5507927075,2339,0,2339,,,
5507927075,2788,0,2788,,,
5507927300,8,0,8,,,
5507927300,421,0,421,,,
5507927300,432,0,432,,,
5507927300,456,0,456,,,
5507927300,499,0,499,,,
5507927300,584,0,584,,,
5507927300,722,0,722,,,
5507927300,737,0,737,,,
5507927300,737,0,737,,,
5507927300,768,0,768,,,
5507927300,793,0,793,,,
5507927300,882,0,882,,,
5507927300,923,0,923,,,
5507927300,1014,0,1014,,,
5507927300,1051,0,1051,,,
5507927300,1070,0,1070,,,
5507927300,1073,0,1073,,,
5507927300,1220,0,1220,,,
5507927300,1252,0,1252,,,
5507927300,1283,0,1283,,,
5507927300,1301,0,1301,,,
5507927300,1385,0,1385,,,
5507927300,1495,0,1495,,,
5507927300,1531,0,1531,,,
5507927300,1712,0,1712,,,
5507929400,419,0,419,,,
5507929400,584,0,584,,,
5507929400,1058,0,1058,,,
5507929400,1370,0,1370,,,
5507929400,1432,0,1432,,,
5507929400,1560,0,1560,,,
5507929400,1758,0,1758,,,
5507929400,1767,0,1767,,,
5507931125,1860,0,1860,,,
5507931125,1930,0,1930,,,
5507931125,2000,0,2000,,,
5507931125,2165,0,2165,,,
5507931125,2364,0,2364,,,
5507931175,447,0,447,,,
5507931175,725,0,725,,,
5507931175,936,0,936,,,
5507931175,974,0,974,,,
5507931175,1000,0,1000,,,
5507931175,1033,0,1033,,,
5507931175,1035,0,1035,,,
5507931175,1053,0,1053,,,
5507931175,1058,0,1058,,,
5507931175,1063,0,1063,,,
5507931175,1109,0,1109,,,
5507931175,1140,0,1140,,,
5507931175,1194,0,1194,,,
5507931175,1246,0,1246,,,
5507931175,1254,0,1254,,,
5507931175,1281,0,1281,,,
5507931175,1360,0,1360,,,
5507931175,1377,0,1377,,,
5507931175,1389,0,1389,,,
5507931175,1450,0,1450,,,
5507931175,1489,0,1489,,,
5507932075,1669,0,1669,,,
5507932075,1824,0,1824,,,
5507932075,1867,0,1867,,,
5507953000,0,0,0,,,
5507953000,6,0,6,,,
5507953000,59,0,59,,,
5507953000,162,0,162,,,
5507953000,178,0,178,,,
5507953000,212,0,212,,,
5507953000,294,0,294,,,
5507953000,307,0,307,,,
5507953000,324,0,324,,,
5507953000,326,0,326,,,
5507953000,334,0,334,,,
5507953000,343,0,343,,,
5507953000,345,0,345,,,
5507953000,354,0,354,,,
5507953000,368,0,368,,,
5507953000,395,0,395,,,
5507953000,417,0,417,,,
5507953000,434,0,434,,,
5507953000,435,0,435,,,
5507953000,438,0,438,,,
5507953000,438,0,438,,,
5507953000,445,0,445,,,
5507953000,488,0,488,,,
5507953000,489,0,489,,,
5507953000,497,0,497,,,
5507953000,501,0,501,,,
5507953000,509,0,509,,,
5507953000,509,0,509,,,
5507953000,529,0,529,,,
5507953000,535,0,535,,,
5507953000,535,0,535,,,
5507953000,547,0,547,,,
5507953000,552,0,552,,,
5507953000,554,0,554,,,
5507953000,581,0,581,,,
5507953000,588,0,588,,,
5507953000,602,0,602,,,
5507953000,607,0,607,,,
5507953000,631,0,631,,,
5507953000,633,0,633,,,
5507953000,634,0,634,,,
5507953000,634,0,634,,,
5507953000,639,0,639,,,
5507953000,644,0,644,,,
5507953000,649,0,649,,,
5507953000,650,0,650,,,
5507953000,652,0,652,,,
5507953000,662,0,662,,,
5507953000,664,0,664,,,
5507953000,666,0,666,,,
5507953000,671,0,671,,,
5507953000,677,0,677,,,
5507953000,678,0,678,,,
5507953000,686,0,686,,,
5507953000,691,0,691,,,
5507953000,695,0,695,,,
5507953000,703,0,703,,,
5507953000,704,0,704,,,
5507953000,707,0,707,,,
5507953000,708,0,708,,,
5507953000,712,0,712,,,
5507953000,717,0,717,,,
5507953000,725,0,725,,,
5507953000,728,0,728,,,
5507953000,730,0,730,,,
5507953000,733,0,733,,,
5507953000,734,0,734,,,
5507953000,737,0,737,,,
5507953000,738,0,738,,,
5507953000,741,0,741,,,
5507953000,758,0,758,,,
5507953000,772,0,772,,,
5507953000,774,0,774,,,
5507953000,775,0,775,,,
5507953000,777,0,777,,,
5507953000,781,0,781,,,
5507953000,783,0,783,,,
5507953000,787,0,787,,,
5507953000,790,0,790,,,
5507953000,796,0,796,,,
5507953000,803,0,803,,,
5507953000,807,0,807,,,
5507953000,809,0,809,,,
5507953000,810,0,810,,,
5507953000,810,0,810,,,
5507953000,811,0,811,,,
5507953000,812,0,812,,,
5507953000,816,0,816,,,
5507953000,824,0,824,,,
5507953000,825,0,825,,,
5507953000,832,0,832,,,
5507953000,835,0,835,,,
5507953000,838,0,838,,,
5507953000,846,0,846,,,
5507953000,852,0,852,,,
5507953000,854,0,854,,,
5507953000,854,0,854,,,
5507953000,861,0,861,,,
5507953000,866,0,866,,,
5507953000,870,0,870,,,
5507953000,870,0,870,,,
5507953000,871,0,871,,,
5507953000,874,0,874,,,
5507953000,879,0,879,,,
5507953000,880,0,880,,,
5507953000,881,0,881,,,
5507953000,883,0,883,,,
5507953000,887,0,887,,,
5507953000,889,0,889,,,
5507953000,890,0,890,,,
5507953000,891,0,891,,,
5507953000,893,0,893,,,
5507953000,898,0,898,,,
5507953000,899,0,899,,,
5507953000,899,0,899,,,
5507953000,903,0,903,,,
5507953000,910,0,910,,,
5507953000,917,0,917,,,
5507953000,921,0,921,,,
5507953000,922,0,922,,,
5507953000,923,0,923,,,
5507953000,926,0,926,,,
5507953000,926,0,926,,,
5507953000,928,0,928,,,
5507953000,932,0,932,,,
5507953000,935,0,935,,,
5507953000,935,0,935,,,
5507953000,940,0,940,,,
5507953000,941,0,941,,,
5507953000,943,0,943,,,
5507953000,943,0,943,,,
5507953000,945,0,945,,,
5507953000,946,0,946,,,
5507953000,948,0,948,,,
5507953000,949,0,949,,,
5507953000,950,0,950,,,
5507953000,954,0,954,,,
5507953000,958,0,958,,,
5507953000,960,0,960,,,
5507953000,961,0,961,,,
5507953000,962,0,962,,,
5507953000,969,0,969,,,
5507953000,974,0,974,,,
5507953000,975,0,975,,,
5507953000,981,0,981,,,
5507953000,984,0,984,,,
5507953000,990,0,990,,,
5507953000,991,0,991,,,
5507953000,995,0,995,,,
5507953000,995,0,995,,,
5507953000,1001,0,1001,,,
5507953000,1005,0,1005,,,
5507953000,1010,0,1010,,,
5507953000,1016,0,1016,,,
5507953000,1016,0,1016,,,
5507953000,1017,0,1017,,,
5507953000,1022,0,1022,,,
5507953000,1024,0,1024,,,
5507953000,1037,0,1037,,,
5507953000,1039,0,1039,,,
5507953000,1040,0,1040,,,
5507953000,1045,0,1045,,,
5507953000,1048,0,1048,,,
5507953000,1054,0,1054,,,
5507953000,1058,0,1058,,,
5507953000,1058,0,1058,,,
5507953000,1061,0,1061,,,
5507953000,1064,0,1064,,,
5507953000,1066,0,1066,,,
5507953000,1068,0,1068,,,
5507953000,1068,0,1068,,,
5507953000,1070,0,1070,,,
5507953000,1075,0,1075,,,
5507953000,1076,0,1076,,,
5507953000,1076,0,1076,,,
5507953000,1081,0,1081,,,
5507953000,1081,0,1081,,,
5507953000,1088,0,1088,,,
5507953000,1097,0,1097,,,
5507953000,1100,0,1100,,,
5507953000,1102,0,1102,,,
5507953000,1103,0,1103,,,
5507953000,1108,0,1108,,,
5507953000,1112,0,1112,,,
5507953000,1116,0,1116,,,
5507953000,1117,0,1117,,,
5507953000,1122,0,1122,,,
5507953000,1126,0,1126,,,
5507953000,1129,0,1129,,,
5507953000,1132,0,1132,,,
5507953000,1140,0,1140,,,
5507953000,1141,0,1141,,,
5507953000,1145,0,1145,,,
5507953000,1146,0,1146,,,
5507953000,1148,0,1148,,,
5507953000,1155,0,1155,,,
5507953000,1156,0,1156,,,
5507953000,1156,0,1156,,,
5507953000,1166,0,1166,,,
5507953000,1174,0,1174,,,
5507953000,1174,0,1174,,,
5507953000,1175,0,1175,,,
5507953000,1177,0,1177,,,
5507953000,1186,0,1186,,,
5507953000,1189,0,1189,,,
5507953000,1207,0,1207,,,
5507953000,1215,0,1215,,,
5507953000,1217,0,1217,,,
5507953000,1218,0,1218,,,
5507953000,1219,0,1219,,,
5507953000,1220,0,1220,,,
5507953000,1224,0,1224,,,
5507953000,1224,0,1224,,,
5507953000,1227,0,1227,,,
5507953000,1231,0,1231,,,
5507953000,1233,0,1233,,,
5507953000,1235,0,1235,,,
5507953000,1248,0,1248,,,
5507953000,1257,0,1257,,,
5507953000,1262,0,1262,,,
5507953000,1268,0,1268,,,
5507953000,1269,0,1269,,,
5507953000,1271,0,1271,,,
5507953000,1273,0,1273,,,
5507953000,1280,0,1280,,,
5507953000,1283,0,1283,,,
5507953000,1290,0,1290,,,
5507953000,1290,0,1290,,,
5507953000,1293,0,1293,,,
5507953000,1297,0,1297,,,
5507953000,1299,0,1299,,,
5507953000,1300,0,1300,,,
5507953000,1306,0,1306,,,
5507953000,1307,0,1307,,,
5507953000,1308,0,1308,,,
5507953000,1316,0,1316,,,
5507953000,1321,0,1321,,,
5507953000,1323,0,1323,,,
5507953000,1333,0,1333,,,
5507953000,1351,0,1351,,,
5507953000,1358,0,1358,,,
5507953000,1363,0,1363,,,
5507953000,1363,0,1363,,,
5507953000,1370,0,1370,,,
5507953000,1371,0,1371,,,
5507953000,1375,0,1375,,,
5507953000,1379,0,1379,,,
5507953000,1382,0,1382,,,
5507953000,1382,0,1382,,,
5507953000,1399,0,1399,,,
5507953000,1422,0,1422,,,
5507953000,1431,0,1431,,,
5507953000,1433,0,1433,,,
5507953000,1437,0,1437,,,
5507953000,1443,0,1443,,,
5507953000,1449,0,1449,,,
5507953000,1450,0,1450,,,
5507953000,1450,0,1450,,,
5507953000,1452,0,1452,,,
5507953000,1459,0,1459,,,
5507953000,1466,0,1466,,,
5507953000,1467,0,1467,,,
5507953000,1470,0,1470,,,
5507953000,1484,0,1484,,,
5507953000,1506,0,1506,,,
5507953000,1516,0,1516,,,
5507953000,1520,0,1520,,,
5507953000,1525,0,1525,,,
5507953000,1531,0,1531,,,
5507953000,1536,0,1536,,,
5507953000,1540,0,1540,,,
5507953000,1548,0,1548,,,
5507953000,1551,0,1551,,,
5507953000,1552,0,1552,,,
5507953000,1552,0,1552,,,
5507953000,1563,0,1563,,,
5507953000,1573,0,1573,,,
5507953000,1585,0,1585,,,
5507953000,1588,0,1588,,,
5507953000,1592,0,1592,,,
5507953000,1628,0,1628,,,
5507953000,1631,0,1631,,,
5507953000,1636,0,1636,,,
5507953000,1696,0,1696,,,
5507953000,1702,0,1702,,,
5507953000,1707,0,1707,,,
5507953000,1722,0,1722,,,
5507953000,1747,0,1747,,,
5507953000,1751,0,1751,,,
5507953000,1754,0,1754,,,
5507953000,1774,0,1774,,,
5507953000,1780,0,1780,,,
5507953000,1798,0,1798,,,
5507953000,1799,0,1799,,,
5507953000,1837,0,1837,,,
5507953000,1846,0,1846,,,
5507953000,1893,0,1893,,,
5507953000,1903,0,1903,,,
5507953000,1904,0,1904,,,
5507953000,1933,0,1933,,,
5507953000,1950,0,1950,,,
5507953000,1954,0,1954,,,
5507953000,1975,0,1975,,,
5507953000,1981,0,1981,,,
5507953000,2045,0,2045,,,
5507953000,2052,0,2052,,,
5507953000,2091,0,2091,,,
5507953000,2101,0,2101,,,
5507953000,2132,0,2132,,,
5507953000,2169,0,2169,,,
5507953000,2170,0,2170,,,
5507953000,2197,0,2197,,,
5507953000,2213,0,2213,,,
5507953000,2221,0,2221,,,
5507953000,2249,0,2249,,,
5507953000,2269,0,2269,,,
5507953000,2305,0,2305,,,
5507953000,2310,0,2310,,,
5507953000,2394,0,2394,,,
5507953000,2582,0,2582,,,
5507953000,2621,0,2621,,,
5507953000,2668,0,2668,,,
5507953000,2735,0,2735,,,
5507953000,3001,0,3001,,,
5507953000,3037,0,3037,,,
5507958800,3176,0,3176,,,
5507958800,3295,0,3295,,,
5507958800,3355,0,3355,,,
5507958800,3375,0,3375,,,
5507958800,3698,0,3698,,,
5507958800,3909,0,3909,,,
5507968325,1680,0,1680,,,
5507970650,1935,0,1935,,,
5507970650,2084,0,2084,,,
5507970650,2327,0,2327,,,
5507973725,3234,0,3234,,,
5507973725,3524,0,3524,,,
5507973725,4191,0,4191,,,
5507975125,3611,0,3611,,,
5507975125,3658,0,3658,,,
5507975125,3995,0,3995,,,
5507975125,4007,0,4007,,,
5507984675,738,0,738,,,
5507984675,817,0,817,,,
5507984675,1129,0,1129,,,
5507984675,1204,0,1204,,,
5507984675,1342,0,1342,,,
5507984675,1372,0,1372,,,
5507984675,1394,0,1394,,,
5507984675,1395,0,1395,,,
5507984675,1396,0,1396,,,
5507984675,1409,0,1409,,,
5507984675,1446,0,1446,,,
5507984675,1452,0,1452,,,
5507984675,1499,0,1499,,,
5507984675,1518,0,1518,,,
5507984675,1545,0,1545,,,
5507984675,1606,0,1606,,,
5507984675,1646,0,1646,,,
5507984675,1668,0,1668,,,
5507984675,1692,0,1692,,,
5507984675,1719,0,1719,,,
5507984675,1741,0,1741,,,
5507984675,1765,0,1765,,,
5507984675,1881,0,1881,,,
5507984675,2174,0,2174,,,
5507985300,1100,0,1100,,,
5507985300,1196,0,1196,,,
5507985300,1213,0,1213,,,
5507985300,1234,0,1234,,,
5507985300,1236,0,1236,,,
5507985300,1240,0,1240,,,
5507985300,1251,0,1251,,,
5507985300,1259,0,1259,,,
5507985300,1274,0,1274,,,
5507985300,1283,0,1283,,,
5507985300,1323,0,1323,,,
5507985300,1472,0,1472,,,
5507985300,1473,0,1473,,,
5507985300,1547,0,1547,,,
5507985300,1572,0,1572,,,
5507985300,1587,0,1587,,,
5507985300,1606,0,1606,,,
5507985300,1622,0,1622,,,
5507985300,1645,0,1645,,,
5507985300,1683,0,1683,,,
5507985300,1758,0,1758,,,
5507985300,1761,0,1761,,,
5507985300,1774,0,1774,,,
5507985300,1918,0,1918,,,
5507985300,2062,0,2062,,,
5507985875,1040,0,1040,,,
5507985875,1119,0,1119,,,
5507986700,950,0,950,,,
5507986700,1072,0,1072,,,
5507986700,1353,0,1353,,,
5507986700,1548,0,1548,,,
5507986700,1765,0,1765,,,
5507986700,1793,0,1793,,,
5507986700,2023,0,2023,,,
5508100475,523,0,523,,,
5508102025,707,0,707,,,
5508111625,692,0,692,,,
5508112950,501,0,501,,,
5508115550,274,0,274,,,
5508129450,377,0,377,,,
5508130325,278,0,278,,,
5508131225,487,0,487,,,
5508137950,338,0,338,,,
5508139150,237,0,237,,,
5508140925,191,0,191,,,
5508141000,85,0,85,,,
5508141000,1130,0,1130,,,
5508143475,691,0,691,,,
5508144450,516,0,516,,,
5508144975,866,0,866,,,
5508150800,42,0,42,,,
5508156950,115,0,115,,,
5508158575,275,0,275,,,
5508158850,129,0,129,,,
5508158875,415,0,415,,,
5508164425,450,0,450,,,
5508167850,334,0,334,,,
5508172325,59,0,59,,,
5508173150,26016,0,26016,,,
5508175325,0,0,0,,,
5508175325,1432,0,1432,,,
5508175325,1795,0,1795,,,
5508175325,1800,0,1800,,,
5508175325,2000,0,2000,,,
5508175350,1850,0,1850,,,
5508180075,0,0,0,,,
5508180075,1,0,1,,,
5508180075,4697,0,4697,,,
5508180100,843,0,843,,,
5508183450,267,0,267,,,
5508185125,318,0,318,,,
5508185150,335,0,335,,,
5508187525,294,0,294,,,
5508187550,288,0,288,,,
5508189275,76,0,76,,,
5508199999,0,0,0,,,
5508300175,1240,0,1240,,,
5508304275,204,0,204,,,
5508309375,964,0,964,,,
5508309425,459,0,459,,,
5508314125,1879,0,1879,,,
5508320475,241,0,241,,,
5508329050,746,0,746,,,
5508329075,660,0,660,,,
5508335925,399,0,399,,,
5508342075,656,0,656,,,
5508343325,313,0,313,,,
5508343350,450,0,450,,,
5508345175,666,0,666,,,
5508345275,3170,0,3170,,,
5508349000,447,0,447,,,
5508354200,655,0,655,,,
5508354630,572,0,572,,,
5508359350,2665,0,2665,,,
5508359375,856,0,856,,,
5508359400,1522,0,1522,,,
5508359425,790,0,790,,,
5508361900,886,0,886,,,
5508365675,0,0,0,,,
5508368400,578,0,578,,,
5508376450,522,0,522,,,
5508377300,927,0,927,,,
5508378725,296,0,296,,,
5508380325,799,0,799,,,
5508381475,514,0,514,,,
5508513025,779,0,779,,,
5508517625,1558,0,1558,,,
5508524125,267,0,267,,,
5508533575,948,0,948,,,
5508541887,758,0,758,,,
5508545150,258,0,258,,,
5508546650,98,0,98,,,
5508553225,3612,0,3612,,,
5508553662,180,0,180,,,
5508556425,283,0,283,,,
5508556425,1779,0,1779,,,
5508557450,1034,0,1034,,,
5508561625,1865,0,1865,,,
5508562600,57,0,57,,,
5508562925,1923,0,1923,,,
5508567200,502,0,502,,,
5508567200,529,0,529,,,
5508567200,535,0,535,,,
5508567200,543,0,543,,,
5508567200,550,0,550,,,
5508567200,556,0,556,,,
5508567200,567,0,567,,,
5508567200,628,0,628,,,
5508572125,279,0,279,,,
5508576975,457,0,457,,,
5508578075,1316,0,1316,,,
5508579700,1810,0,1810,,,
5508588625,615,0,615,,,
5508588950,1521,0,1521,,,
5508702375,0,0,0,,,
5508702375,0,0,0,,,
5508702375,1,0,1,,,
5508702375,3,0,3,,,
5508702375,4,0,4,,,
5508702375,11,0,11,,,
5508702375,18,0,18,,,
5508702375,28,0,28,,,
5508702375,30,0,30,,,
5508702375,34,0,34,,,
5508702375,113,0,113,,,
5508702375,122,0,122,,,
5508702375,130,0,130,,,
5508702375,172,0,172,,,
5508702375,213,0,213,,,
5508702375,375,0,375,,,
5508702375,559,0,559,,,
5508702375,570,0,570,,,
5508702375,610,0,610,,,
5508702375,658,0,658,,,
5508702375,703,0,703,,,
5508702375,734,0,734,,,
5508702375,752,0,752,,,
5508702375,810,0,810,,,
5508702375,829,0,829,,,
5508702375,922,0,922,,,
5508702375,961,0,961,,,
5508702375,969,0,969,,,
5508702375,998,0,998,,,
5508702375,999,0,999,,,
5508702375,1030,0,1030,,,
5508702375,1049,0,1049,,,
5508702375,1079,0,1079,,,
5508702375,1093,0,1093,,,
5508702375,1113,0,1113,,,
5508702375,1124,0,1124,,,
5508702375,1166,0,1166,,,
5508702375,1172,0,1172,,,
5508702375,1182,0,1182,,,
5508702375,1211,0,1211,,,
5508702375,1283,0,1283,,,
5508702375,1311,0,1311,,,
5508702375,1443,0,1443,,,
5508702375,1500,0,1500,,,
5508702375,1586,0,1586,,,
5508702375,1594,0,1594,,,
5508702375,1691,0,1691,,,
5508702375,1701,0,1701,,,
5508702375,1960,0,1960,,,
5508705575,160,0,160,,,
5508707725,754,0,754,,,
5508707750,779,0,779,,,
5508708975,771,0,771,,,
5508710750,4582,0,4582,,,
5508713600,2404,0,2404,,,
5508714750,652,0,652,,,
5508716500,2282,0,2282,,,
5508718525,1839,0,1839,,,
5508719200,358,0,358,,,
5508723425,1858,0,1858,,,
5508727650,3784,0,3784,,,
5508730075,0,0,0,,,
5508730075,256,0,256,,,
5508730075,889,0,889,,,
5508730075,1493,0,1493,,,
5508730075,2304,0,2304,,,
5508730075,2734,0,2734,,,
5508730075,3098,0,3098,,,
5508730075,3537,0,3537,,,
5508731550,1289,0,1289,,,
5508731550,4171,0,4171,,,
5508732790,0,0,0,,,
5508735825,725,0,725,,,
5508735850,1777,0,1777,,,
5508735950,0,0,0,,,
5508738800,2010,0,2010,,,
5508738800,2200,0,2200,,,
5508738800,2280,0,2280,,,
5508738800,2404,0,2404,,,
5508738825,806,0,806,,,
5508739650,4323,0,4323,,,
5508743875,560,0,560,,,
5508744950,1172,0,1172,,,
5508744950,1260,0,1260,,,
5508744950,1529,0,1529,,,
5508744950,2501,0,2501,,,
5508748250,516,0,516,,,
5508748775,390,0,390,,,
5508756925,798,0,798,,,
5508757375,134,0,134,,,
5508760000,2388,0,2388,,,
5508760400,768,0,768,,,
5508772725,2050,0,2050,,,
5508772750,731,0,731,,,
5508773625,528,0,528,,,
5508782400,1056,0,1056,,,
5508789150,0,0,0,,,
5508789150,124,0,124,,,
5508905450,79,0,79,,,
5508906150,1454,0,1454,,,
5508906175,1080,0,1080,,,
5508913375,1102,0,1102,,,
5508913375,1149,0,1149,,,
5508913375,1217,0,1217,,,
5508913375,1224,0,1224,,,
5508913375,1253,0,1253,,,
5508913375,1274,0,1274,,,
5508913375,1307,0,1307,,,
5508913400,1008,0,1008,,,
5508913400,1138,0,1138,,,
5508913400,1256,0,1256,,,
5508913400,1303,0,1303,,,
5508927550,1442,0,1442,,,
5508927575,1478,0,1478,,,
5508930000,535,0,535,,,
5508930000,556,0,556,,,
5508930000,567,0,567,,,
5508930000,578,0,578,,,
5508930000,590,0,590,,,
5508930000,592,0,592,,,
5508930000,615,0,615,,,
5508930000,622,0,622,,,
5508930000,622,0,622,,,
5508930000,641,0,641,,,
5508930000,643,0,643,,,
5508930000,644,0,644,,,
5508930000,644,0,644,,,
5508930000,650,0,650,,,
5508930025,1612,0,1612,,,
5508930025,1631,0,1631,,,
5508951150,589,0,589,,,
5508951150,641,0,641,,,
5508951150,824,0,824,,,
5508951150,899,0,899,,,
5508951150,989,0,989,,,
5508951150,1033,0,1033,,,
5508951150,1330,0,1330,,,
5508951150,1473,0,1473,,,
5508951150,1630,0,1630,,,
5508951150,2124,0,2124,,,
5508951150,2255,0,2255,,,
5508951150,2267,0,2267,,,
5508951150,2303,0,2303,,,
5508956450,56,0,56,,,
5508964450,1052,0,1052,,,
5508964450,1070,0,1070,,,
5508964450,1078,0,1078,,,
5508964450,1160,0,1160,,,
5508964450,1198,0,1198,,,
5508964450,1243,0,1243,,,
5508964450,1265,0,1265,,,
5508964475,1148,0,1148,,,
5508971700,862,0,862,,,
5508971700,962,0,962,,,
5508971700,1062,0,1062,,,
5508971725,1536,0,1536,,,
5508979475,1102,0,1102,,,
5508979475,1349,0,1349,,,
5509100800,380,0,380,,,
5509121225,1102,0,1102,,,
5509121250,438,0,438,,,
5509127175,238,0,238,,,
5509144075,358,0,358,,,
5509161925,484,0,484,,,
5509161950,522,0,522,,,
5509177475,55,0,55,,,
5509177500,153,0,153,,,
5509184025,613,0,613,,,
5509184100,267,0,267,,,
5509305325,248,0,248,,,
5509315575,1489,0,1489,,,
5509320150,324,0,324,,,
5509323525,1852,0,1852,,,
5509323550,808,0,808,,,
5509323700,469,0,469,,,
5509323775,437,0,437,,,
5509329150,656,0,656,,,
5509333050,550,0,550,,,
5509337350,164,0,164,,,
5509348175,82,0,82,,,
5509348200,389,0,389,,,
5509349775,763,0,763,,,
5509359025,1504,0,1504,,,
5509363600,356,0,356,,,
5509365375,2673,0,2673,,,
5509368275,290,0,290,,,
5509368275,1717,0,1717,,,
5509368275,1825,0,1825,,,
5509368275,2184,0,2184,,,
5509368300,1667,0,1667,,,
5509368775,280,0,280,,,
5509371150,327,0,327,,,
5509376100,391,0,391,,,
5509376300,851,0,851,,,
5509380550,1205,0,1205,,,
5509380700,1096,0,1096,,,
5509381600,376,0,376,,,
5509500950,1821,0,1821,,,
5509501725,1629,0,1629,,,
5509502350,88,0,88,,,
5509504475,565,0,565,,,
5509504500,885,0,885,,,
5509505825,517,0,517,,,
5509507700,826,0,826,,,
5509508750,471,0,471,,,
5509513850,420,0,420,,,
5509514837,341,0,341,,,
5509515100,269,0,269,,,
5509515125,608,0,608,,,
5509515250,585,0,585,,,
5509515275,515,0,515,,,
5509520850,528,0,528,,,
5509524450,1059,0,1059,,,
5509525350,1195,0,1195,,,
5509527500,589,0,589,,,
5509528350,1044,0,1044,,,
5509528725,657,0,657,,,
5509538400,322,0,322,,,
5509541900,659,0,659,,,
5509544475,1459,0,1459,,,
5509545775,189,0,189,,,
5509546200,779,0,779,,,
5509546225,586,0,586,,,
5509546900,217,0,217,,,
5509552075,434,0,434,,,
5509552100,782,0,782,,,
5509560450,1496,0,1496,,,
5509560475,1843,0,1843,,,
5509570550,1395,0,1395,,,
5509570575,741,0,741,,,
5509577050,405,0,405,,,
5509581075,0,0,0,,,
5509581075,41,0,41,,,
5509586350,441,0,441,,,
5509700725,562,0,562,,,
5509701400,232,0,232,,,
5509701425,461,0,461,,,
5509701750,695,0,695,,,
5509701775,961,0,961,,,
5509701800,238,0,238,,,
5509706475,415,0,415,,,
5509710925,784,0,784,,,
5509712725,951,0,951,,,
5509719975,663,0,663,,,
5509722450,642,0,642,,,
5509730350,267,0,267,,,
5509730350,1002,0,1002,,,
5509736350,1186,0,1186,,,
5509736350,1273,0,1273,,,
5509736350,1327,0,1327,,,
5509738650,226,0,226,,,
5509742225,1010,0,1010,,,
5509744800,799,0,799,,,
5509751875,5,0,5,,,
5509756000,116,0,116,,,
5509756850,564,0,564,,,
5509761325,385,0,385,,,
5509762825,458,0,458,,,
5509763525,2183,0,2183,,,
5509763525,2675,0,2675,,,
5509763525,3108,0,3108,,,
5509763550,1028,0,1028,,,
5509769575,283,0,283,,,
5509772850,1414,0,1414,,,
5509777200,0,0,0,,,
5509777200,0,0,0,,,
5509777200,1,0,1,,,
5509777200,1,0,1,,,
5509777200,1488,0,1488,,,
5509777200,1507,0,1507,,,
5509777200,1553,0,1553,,,
5509777200,1616,0,1616,,,
5509777200,1739,0,1739,,,
5509777200,1746,0,1746,,,
5509777200,1803,0,1803,,,
5509777200,1827,0,1827,,,
5509777200,1913,0,1913,,,
5509777200,1953,0,1953,,,
5509777200,2080,0,2080,,,
5509777537,2057,0,2057,,,
5509786975,1148,0,1148,,,
5509913175,73,0,73,,,
5509913200,170,0,170,,,
5509922950,456,0,456,,,
5509923200,762,0,762,,,
5509923975,222,0,222,,,
5509925775,207,0,207,,,
5509925775,453,0,453,,,
5509926050,355,0,355,,,
5509928750,112,0,112,,,
5509931925,132,0,132,,,
5509932675,169,0,169,,,
5509934725,225,0,225,,,
5509939175,89,0,89,,,
5509939200,218,0,218,,,
5509940175,217,0,217,,,
5509941150,806,0,806,,,
5509959525,459,0,459,,,
5509961200,1370,0,1370,,,
5509962450,887,0,887,,,
5509965325,345,0,345,,,
5509965350,275,0,275,,,
5509975525,198,0,198,,,
5509989100,1183,0,1183,,,
5510111200,2965,0,2965,,,
5510111200,3283,0,3283,,,
5510111225,488,0,488,,,
5510111225,1222,0,1222,,,
5510111225,2443,0,2443,,,
5510111950,0,0,0,,,
5510111950,639,0,639,,,
5510111950,2195,0,2195,,,
5510111950,2394,0,2394,,,
5510111950,2588,0,2588,,,
5510111950,2835,0,2835,,,
5510111950,3514,0,3514,,,
5510111950,3716,0,3716,,,
5510120625,2445,0,2445,,,
5510123725,359,0,359,,,
5510154875,622,0,622,,,
5510154875,969,0,969,,,
5510154875,1292,0,1292,,,
5510154875,1454,0,1454,,,
5510154875,2768,0,2768,,,
5510154875,3447,0,3447,,,
5510154875,3620,0,3620,,,
5510154875,4618,0,4618,,,
5510157700,188,0,188,,,
5510158600,5537,0,5537,,,
5510166000,191,0,191,,,
5510166000,576,0,576,,,
5510166000,611,0,611,,,
5510166000,685,0,685,,,
5510166000,688,0,688,,,
5510166000,723,0,723,,,
5510166000,763,0,763,,,
5510166000,861,0,861,,,
5510166000,871,0,871,,,
5510166000,913,0,913,,,
5510166000,959,0,959,,,
5510166000,974,0,974,,,
5510166000,1038,0,1038,,,
5510166000,1061,0,1061,,,
5510166000,1064,0,1064,,,
5510166000,1068,0,1068,,,
5510166000,1069,0,1069,,,
5510166000,1092,0,1092,,,
5510166000,1103,0,1103,,,
5510166000,1112,0,1112,,,
5510166000,1133,0,1133,,,
5510166000,1234,0,1234,,,
5510166000,1235,0,1235,,,
5510166000,1241,0,1241,,,
5510166000,1332,0,1332,,,
5510166000,1357,0,1357,,,
5510166000,1428,0,1428,,,
5510166000,1465,0,1465,,,
5510166000,1521,0,1521,,,
5510166000,1537,0,1537,,,
5510166000,1539,0,1539,,,
5510166000,1679,0,1679,,,
5510166000,1743,0,1743,,,
5510166000,1744,0,1744,,,
5510166000,1768,0,1768,,,
5510166000,1890,0,1890,,,
5510166375,2837,0,2837,,,
5510168550,2612,0,2612,,,
5510177925,3467,0,3467,,,
5510181775,2985,0,2985,,,
5510183825,3542,0,3542,,,
5510183850,4386,0,4386,,,
5510187700,1407,0,1407,,,
5510189575,2154,0,2154,,,
5510300675,257,0,257,,,
5510308175,285,0,285,,,
5510308600,93,0,93,,,
5510310950,2,0,2,,,
5510310950,956,0,956,,,
5510313300,180,0,180,,,
5510319000,421,0,421,,,
5510321400,302,0,302,,,
5510326475,208,0,208,,,
5510333925,310,0,310,,,
5510337500,399,0,399,,,
5510345575,494,0,494,,,
5510349600,378,0,378,,,
5510360350,307,0,307,,,
5510367575,809,0,809,,,
5510367625,335,0,335,,,
5510367625,336,0,336,,,
5510367625,344,0,344,,,
5510367625,353,0,353,,,
5510367625,362,0,362,,,
5510367625,373,0,373,,,
5510367625,378,0,378,,,
5510367625,383,0,383,,,
5510367625,391,0,391,,,
5510367625,418,0,418,,,
5510367625,419,0,419,,,
5510367625,436,0,436,,,
5510367775,325,0,325,,,
5510368675,452,0,452,,,
5510378825,264,0,264,,,
5510382900,218,0,218,,,
5510385675,330,0,330,,,
5510387250,307,0,307,,,
5510389625,43,0,43,,,
5510504100,400,0,400,,,
5510506500,0,0,0,,,
5510506500,60,0,60,,,
5510506500,338,0,338,,,
5510506500,463,0,463,,,
5510506500,553,0,553,,,
5510506500,560,0,560,,,
5510506500,598,0,598,,,
5510506500,626,0,626,,,
5510506500,647,0,647,,,
5510506500,655,0,655,,,
5510506500,704,0,704,,,
5510506500,744,0,744,,,
5510506500,755,0,755,,,
5510506500,768,0,768,,,
5510506500,769,0,769,,,
5510506500,770,0,770,,,
5510506500,783,0,783,,,
5510506500,788,0,788,,,
5510506500,790,0,790,,,
5510506500,862,0,862,,,
5510506500,915,0,915,,,
5510506500,923,0,923,,,
5510506500,997,0,997,,,
5510506500,1292,0,1292,,,
5510506500,1673,0,1673,,,
5510506525,253,0,253,,,
5510506525,1290,0,1290,,,
5510506525,1425,0,1425,,,
5510506525,1875,0,1875,,,
5510509175,628,0,628,,,
5510509925,38,0,38,,,
5510513625,775,0,775,,,
5510515625,1247,0,1247,,,
5510515650,573,0,573,,,
5510522575,3472,0,3472,,,
5510524550,3293,0,3293,,,
5510526400,511,0,511,,,
5510528075,2306,0,2306,,,
5510532700,3,0,3,,,
5510532700,534,0,534,,,
5510532700,1207,0,1207,,,
5510537825,0,0,0,,,
5510537825,0,0,0,,,
5510537825,1,0,1,,,
5510537825,5,0,5,,,
5510537825,442,0,442,,,
5510537825,553,0,553,,,
5510537825,775,0,775,,,
5510537825,981,0,981,,,
5510537825,992,0,992,,,
5510537825,1007,0,1007,,,
5510537825,1106,0,1106,,,
5510537825,1181,0,1181,,,
5510537825,1200,0,1200,,,
5510537825,1272,0,1272,,,
5510537825,1368,0,1368,,,
5510537825,1406,0,1406,,,
5510537825,1421,0,1421,,,
5510537825,1435,0,1435,,,
5510537825,1437,0,1437,,,
5510537825,1496,0,1496,,,
5510537825,1579,0,1579,,,
5510537825,1631,0,1631,,,
5510537825,1701,0,1701,,,
5510537825,1702,0,1702,,,
5510537825,1713,0,1713,,,
5510537825,1750,0,1750,,,
5510537825,1751,0,1751,,,
5510537825,1761,0,1761,,,
5510537825,1806,0,1806,,,
5510537825,2014,0,2014,,,
5510537825,2151,0,2151,,,
5510537850,258,0,258,,,
5510537850,2229,0,2229,,,
5510538450,520,0,520,,,
5510542575,114,0,114,,,
5510542575,309,0,309,,,
5510544125,736,0,736,,,
5510548150,507,0,507,,,
5510552200,3527,0,3527,,,
5510552225,509,0,509,,,
5510552225,1464,0,1464,,,
5510556325,1064,0,1064,,,
5510560250,879,0,879,,,
5510563675,835,0,835,,,
5510564225,703,0,703,,,
5510568600,1677,0,1677,,,
5510568600,1726,0,1726,,,
5510576325,493,0,493,,,
5510581050,823,0,823,,,
5510581050,1083,0,1083,,,
5510581650,1329,0,1329,,,
5510703600,387,0,387,,,
5510707175,296,0,296,,,
5510707225,101,0,101,,,
5510710500,439,0,439,,,
5510713550,27,0,27,,,
5510716775,51,0,51,,,
5510720000,352,0,352,,,
5510726100,626,0,626,,,
5510729475,51,0,51,,,
5510730375,456,0,456,,,
5510731775,232,0,232,,,
5510733275,183,0,183,,,
5510733300,93,0,93,,,
5510736125,115,0,115,,,
5510736925,59,0,59,,,
5510740850,1752,0,1752,,,
5510742950,154,0,154,,,
5510749625,265,0,265,,,
5510755175,165,0,165,,,
5510767600,154,0,154,,,
5510770275,421,0,421,,,
5510773175,111,0,111,,,
5510774975,82,0,82,,,
5510777775,185,0,185,,,
5510777850,430,0,430,,,
5510779575,495,0,495,,,
5510780225,59,0,59,,,
5510780950,191,0,191,,,
5510783675,238,0,238,,,
5510786450,117,0,117,,,
5510787125,32,0,32,,,
5510787175,296,0,296,,,
5510787450,65,0,65,,,
5510904400,2291,0,2291,,,
5510904425,619,0,619,,,
5510911775,549,0,549,,,
5510918300,412,0,412,,,
5510919325,136,0,136,,,
5510922400,740,0,740,,,
5510923925,484,0,484,,,
5510924275,445,0,445,,,
5510926525,429,0,429,,,
5510929600,469,0,469,,,
5510929625,724,0,724,,,
5510932325,1076,0,1076,,,
5510932350,1445,0,1445,,,
5510936250,1129,0,1129,,,
5510936250,1375,0,1375,,,
5510936250,1396,0,1396,,,
5510936250,1409,0,1409,,,
5510936250,1431,0,1431,,,
5510936250,1652,0,1652,,,
5510936275,6039,0,6039,,,
5510939825,1231,0,1231,,,
5510957100,2235,0,2235,,,
5510957100,2516,0,2516,,,
5510958050,2681,0,2681,,,
5510963425,326,0,326,,,
5510967650,968,0,968,,,
5510967650,1118,0,1118,,,
5510968275,2194,0,2194,,,
5510968475,1033,0,1033,,,
5510970200,347,0,347,,,
5510970825,2772,0,2772,,,
5510974675,1409,0,1409,,,
5510974700,2604,0,2604,,,
5510975950,568,0,568,,,
5510976300,5,0,5,,,
5510976675,569,0,569,,,
5510976825,382,0,382,,,
5510976850,2219,0,2219,,,
5510980800,3439,0,3439,,,
5510983400,1106,0,1106,,,
5510987475,137,0,137,,,
5510989025,713,0,713,,,
5511104625,6725,0,6725,,,
5511104650,1306,0,1306,,,
5511105600,404,0,404,,,
5511113300,15,0,15,,,
5511119550,1062,0,1062,,,
5511119675,1394,0,1394,,,
5511124675,1095,0,1095,,,
5511124900,790,0,790,,,
5511127350,446,0,446,,,
5511127675,325,0,325,,,
5511131250,665,0,665,,,
5511135625,498,0,498,,,
5511137225,135,0,135,,,
5511137250,335,0,335,,,
5511141300,1579,0,1579,,,
5511142825,222,0,222,,,
5511142850,894,0,894,,,
5511144225,105,0,105,,,
5511145400,166,0,166,,,
5511151325,287,0,287,,,
5511151350,738,0,738,,,
5511158025,359,0,359,,,
5511163125,519,0,519,,,
5511165100,3090,0,3090,,,
5511165125,743,0,743,,,
5511166800,972,0,972,,,
5511166800,1209,0,1209,,,
5511166800,1324,0,1324,,,
5511166800,1647,0,1647,,,
5511166825,777,0,777,,,
5511168975,222,0,222,,,
5511171650,2280,0,2280,,,
5511176025,1150,0,1150,,,
5511176050,1145,0,1145,,,
5511178525,479,0,479,,,
5511180825,535,0,535,,,
5511183700,455,0,455,,,
5511185325,867,0,867,,,
5511185625,367,0,367,,,
5511187775,537,0,537,,,
5511188150,5,0,5,,,
5511188150,74,0,74,,,
5511188775,437,0,437,,,
5511305200,1979,0,1979,,,
5511317225,66,0,66,,,
5511317250,192,0,192,,,
5511320825,168,0,168,,,
5511322625,412,0,412,,,
5511324700,100,0,100,,,
5511333450,1335,0,1335,,,
5511333475,1309,0,1309,,,
5511336450,481,0,481,,,
5511343400,1008,0,1008,,,
5511350300,100,0,100,,,
5511351425,116,0,116,,,
5511359600,172,0,172,,,
5511366050,122,0,122,,,
5511366075,270,0,270,,,
5511369750,828,0,828,,,
5511371500,644,0,644,,,
5511375450,328,0,328,,,
5511385100,214,0,214,,,
5511387975,183,0,183,,,
5511388000,694,0,694,,,
5511501375,349,0,349,,,
5511501975,1154,0,1154,,,
5511502075,140,0,140,,,
5511502100,302,0,302,,,
5511505000,423,0,423,,,
5511506275,1172,0,1172,,,
5511507600,406,0,406,,,
5511507625,424,0,424,,,
5511508725,887,0,887,,,
5511509025,163,0,163,,,
5511513325,371,0,371,,,
5511522975,143,0,143,,,
5511524775,381,0,381,,,
5511528825,208,0,208,,,
5511530400,606,0,606,,,
5511531500,622,0,622,,,
5511531675,326,0,326,,,
5511533075,612,0,612,,,
5511534025,489,0,489,,,
5511536700,356,0,356,,,
5511543675,771,0,771,,,
5511548900,588,0,588,,,
5511549400,7,0,7,,,
5511550000,184,0,184,,,
5511554250,275,0,275,,,
5511555675,277,0,277,,,
5511561700,567,0,567,,,
5511565675,90,0,90,,,
5511566750,577,0,577,,,
5511567675,1275,0,1275,,,
5511572550,355,0,355,,,
5511572925,745,0,745,,,
5511572925,987,0,987,,,
5511572925,1020,0,1020,,,
5511572925,1048,0,1048,,,
5511572925,1095,0,1095,,,
5511572925,1112,0,1112,,,
5511579825,412,0,412,,,
5511583725,1217,0,1217,,,
5511584225,654,0,654,,,
5511585275,2074,0,2074,,,
5511588325,562,0,562,,,
5511588350,528,0,528,,,
5511700450,344,0,344,,,
5511712825,431,0,431,,,
5511713475,1436,0,1436,,,
5511723275,816,0,816,,,
5511729350,324,0,324,,,
5511731100,1066,0,1066,,,
5511734050,1320,0,1320,,,
5511735375,1662,0,1662,,,
5511736025,2285,0,2285,,,
5511740275,1618,0,1618,,,
5511744150,2087,0,2087,,,
5511746575,1064,0,1064,,,
5511753375,834,0,834,,,
5511754475,569,0,569,,,
5511760100,2142,0,2142,,,
5511763700,1286,0,1286,,,
5511763700,1309,0,1309,,,
5511763700,1363,0,1363,,,
5511763700,1455,0,1455,,,
5511763725,2226,0,2226,,,
5511766200,1081,0,1081,,,
5511767150,1608,0,1608,,,
5511770350,257,0,257,,,
5511772350,1328,0,1328,,,
5511772975,0,0,0,,,
5511772975,0,0,0,,,
5511772975,0,0,0,,,
5511772975,0,0,0,,,
5511772975,119,0,119,,,
5511772975,135,0,135,,,
5511772975,303,0,303,,,
5511772975,527,0,527,,,
5511772975,595,0,595,,,
5511772975,648,0,648,,,
5511772975,882,0,882,,,
5511772975,898,0,898,,,
5511772975,932,0,932,,,
5511772975,948,0,948,,,
5511772975,993,0,993,,,
5511772975,1022,0,1022,,,
5511772975,1036,0,1036,,,
5511772975,1056,0,1056,,,
5511772975,1060,0,1060,,,
5511772975,1079,0,1079,,,
5511772975,1151,0,1151,,,
5511772975,1184,0,1184,,,
5511772975,1221,0,1221,,,
5511772975,1282,0,1282,,,
5511772975,1380,0,1380,,,
5511772975,1486,0,1486,,,
5511772975,1534,0,1534,,,
5511772975,1590,0,1590,,,
5511772975,1629,0,1629,,,
5511772975,1690,0,1690,,,
5511773000,5357,0,5357,,,
5511773025,1735,0,1735,,,
5511773025,1790,0,1790,,,
5511773025,1966,0,1966,,,
5511773050,1184,0,1184,,,
5511773425,1063,0,1063,,,
5511783100,354,0,354,,,
5511787500,2548,0,2548,,,
5511903900,205,0,205,,,
5511910400,507,0,507,,,
5511914200,461,0,461,,,
5511915450,156,0,156,,,
5511919225,401,0,401,,,
5511926425,155,0,155,,,
5511929175,241,0,241,,,
5511929837,315,0,315,,,
5511931600,391,0,391,,,
5511931750,153,0,153,,,
5511932300,472,0,472,,,
5511935525,329,0,329,,,
5511938627,182,0,182,,,
5511944900,667,0,667,,,
5511946150,58,0,58,,,
5511946925,211,0,211,,,
5511948925,206,0,206,,,
5511950425,2511,0,2511,,,
5511950450,1513,0,1513,,,
5511953550,205,0,205,,,
5511962100,104,0,104,,,
5511967275,478,0,478,,,
5511967300,482,0,482,,,
5511969400,235,0,235,,,
5511977100,285,0,285,,,
5511978950,207,0,207,,,
5511985450,454,0,454,,,
5512100925,396,0,396,,,
5512102500,1105,0,1105,,,
5512102525,1077,0,1077,,,
5512108075,664,0,664,,,
5512111325,277,0,277,,,
5512111975,594,0,594,,,
5512114525,160,0,160,,,
5512120300,274,0,274,,,
5512123175,327,0,327,,,
5512124400,306,0,306,,,
5512124425,839,0,839,,,
5512128150,1095,0,1095,,,
5512128200,980,0,980,,,
5512132050,1086,0,1086,,,
5512136800,624,0,624,,,
5512144500,414,0,414,,,
5512160575,1069,0,1069,,,
5512162650,414,0,414,,,
5512162675,237,0,237,,,
5512165500,497,0,497,,,
5512177825,668,0,668,,,
5512178500,548,0,548,,,
5512180475,1064,0,1064,,,
5512180500,1184,0,1184,,,
5512181875,316,0,316,,,
5512186725,866,0,866,,,
5512306900,920,0,920,,,
5512314150,184,0,184,,,
5512314675,608,0,608,,,
5512315675,298,0,298,,,
5512316875,509,0,509,,,
5512316900,523,0,523,,,
5512319850,167,0,167,,,
5512326550,329,0,329,,,
5512327400,674,0,674,,,
5512328625,169,0,169,,,
5512328650,489,0,489,,,
5512331625,238,0,238,,,
5512332225,640,0,640,,,
5512332725,310,0,310,,,
5512334825,803,0,803,,,
5512334850,422,0,422,,,
5512337975,52,0,52,,,
5512339475,345,0,345,,,
5512340875,422,0,422,,,
5512343900,181,0,181,,,
5512360075,233,0,233,,,
5512366450,222,0,222,,,
5512376725,221,0,221,,,
5512377075,373,0,373,,,
5512377550,537,0,537,,,
5512381675,283,0,283,,,
5512382900,142,0,142,,,
5512382925,2745,0,2745,,,
5512382950,144,0,144,,,
5512385050,435,0,435,,,
5512385475,1360,0,1360,,,
5512386525,415,0,415,,,
5512386900,270,0,270,,,
5512502450,2401,0,2401,,,
5512508950,863,0,863,,,
5512515850,838,0,838,,,
5512516750,959,0,959,,,
5512521625,908,0,908,,,
5512540687,1972,0,1972,,,
5512542325,704,0,704,,,
5512544525,1880,0,1880,,,
5512548462,585,0,585,,,
5512562425,961,0,961,,,
5512563625,448,0,448,,,
5512565425,632,0,632,,,
5512570725,1573,0,1573,,,
5512583750,1217,0,1217,,,
5512587600,391,0,391,,,
5512708275,805,0,805,,,
5512711200,0,0,0,,,
5512718825,858,0,858,,,
5512718850,991,0,991,,,
5512719450,4211,0,4211,,,
5512719475,3197,0,3197,,,
5512722100,2796,0,2796,,,
5512722125,564,0,564,,,
5512722125,994,0,994,,,
5512722125,1326,0,1326,,,
5512723300,0,0,0,,,
5512723300,5582,0,5582,,,
5512726350,1111,0,1111,,,
5512728550,3025,0,3025,,,
5512728675,1534,0,1534,,,
5512740950,1398,0,1398,,,
5512741050,1631,0,1631,,,
5512741450,927,0,927,,,
5512741450,972,0,972,,,
5512741450,1134,0,1134,,,
5512741450,1149,0,1149,,,
5512744750,295,0,295,,,
5512744750,1245,0,1245,,,
5512746725,2254,0,2254,,,
5512755050,75,0,75,,,
5512767725,1241,0,1241,,,
5512772875,788,0,788,,,
5512772900,550,0,550,,,
5512776175,1523,0,1523,,,
5512778100,2586,0,2586,,,
5512780875,1762,0,1762,,,
5512783250,1490,0,1490,,,
5512783275,1099,0,1099,,,
5512786925,1571,0,1571,,,
5512786925,1574,0,1574,,,
5512786925,1970,0,1970,,,
5512786925,3023,0,3023,,,
5512786950,81,0,81,,,
5512786950,967,0,967,,,
5512787200,1858,0,1858,,,
5512799999,2277,0,2277,,,
5512904950,287,0,287,,,
5512905125,702,0,702,,,
5512905225,344,0,344,,,
5512905875,502,0,502,,,
5512907550,257,0,257,,,
5512907575,433,0,433,,,
5512910150,200,0,200,,,
5512912925,331,0,331,,,
5512914425,219,0,219,,,
5512917850,185,0,185,,,
5512924600,786,0,786,,,
5512928025,106,0,106,,,
5512931825,142,0,142,,,
5512945650,500,0,500,,,
5512947025,399,0,399,,,
5512953250,314,0,314,,,
5512953275,647,0,647,,,
5512971637,263,0,263,,,
5512973200,938,0,938,,,
5512975625,1567,0,1567,,,
5512975650,528,0,528,,,
5512975800,296,0,296,,,
5512977350,169,0,169,,,
5512977650,332,0,332,,,
5512980450,669,0,669,,,
5513100425,2450,0,2450,,,
5513105050,1977,0,1977,,,
5513124225,2933,0,2933,,,
5513125375,2545,0,2545,,,
5513128875,3502,0,3502,,,
5513128875,3503,0,3503,,,
5513128875,3545,0,3545,,,
5513128875,3714,0,3714,,,
5513128900,11,0,11,,,
5513133000,405,0,405,,,
5513133000,1307,0,1307,,,
5513133000,1604,0,1604,,,
5513133000,2541,0,2541,,,
5513133000,2959,0,2959,,,
5513133025,2604,0,2604,,,
5513137675,1,0,1,,,
5513137675,4481,0,4481,,,
5513137700,3150,0,3150,,,
5513139300,2691,0,2691,,,
5513139325,802,0,802,,,
5513153000,0,0,0,,,
5513156450,750,0,750,,,
5513163875,2908,0,2908,,,
5513167475,748,0,748,,,
5513167475,976,0,976,,,
5513167475,2042,0,2042,,,
5513167475,2454,0,2454,,,
5513167475,2507,0,2507,,,
5513174400,3471,0,3471,,,
5513180575,725,0,725,,,
5513180575,2704,0,2704,,,
5513184900,1455,0,1455,,,
5513185350,4,0,4,,,
5513185350,2156,0,2156,,,
5513185350,2185,0,2185,,,
5513185350,2240,0,2240,,,
5513185350,2253,0,2253,,,
5513185350,2303,0,2303,,,
5513185350,2517,0,2517,,,
5513185350,2565,0,2565,,,
5513185350,2630,0,2630,,,
5513185375,3768,0,3768,,,
5513307200,916,0,916,,,
5513310025,522,0,522,,,
5513310025,829,0,829,,,
5513310025,890,0,890,,,
5513310025,980,0,980,,,
5513310025,1047,0,1047,,,
5513310025,1057,0,1057,,,
5513310025,1085,0,1085,,,
5513310025,1134,0,1134,,,
5513310025,1144,0,1144,,,
5513310025,1175,0,1175,,,
5513310025,1177,0,1177,,,
5513310025,1218,0,1218,,,
5513310025,1222,0,1222,,,
5513310025,1250,0,1250,,,
5513310025,1364,0,1364,,,
5513310025,1390,0,1390,,,
5513310025,1451,0,1451,,,
5513310025,1452,0,1452,,,
5513310025,1480,0,1480,,,
5513310025,1511,0,1511,,,
5513310025,1528,0,1528,,,
5513310025,1537,0,1537,,,
5513310025,1559,0,1559,,,
5513310025,1567,0,1567,,,
5513310050,345,0,345,,,
5513310050,2008,0,2008,,,
5513310050,2444,0,2444,,,
5513311475,1289,0,1289,,,
5513314225,431,0,431,,,
5513319400,5242,0,5242,,,
5513319425,1104,0,1104,,,
5513319425,1413,0,1413,,,
5513319425,1413,0,1413,,,
5513319425,2364,0,2364,,,
5513320550,1657,0,1657,,,
5513321425,1312,0,1312,,,
5513321450,2477,0,2477,,,
5513323575,2434,0,2434,,,
5513323575,2640,0,2640,,,
5513328487,1764,0,1764,,,
5513328487,1817,0,1817,,,
5513328487,2081,0,2081,,,
5513333100,3105,0,3105,,,
5513333100,3280,0,3280,,,
5513340750,250,0,250,,,
5513342450,805,0,805,,,
5513344850,864,0,864,,,
5513344850,1662,0,1662,,,
5513344850,2454,0,2454,,,
5513344850,2671,0,2671,,,
5513351000,580,0,580,,,
5513351000,654,0,654,,,
5513351000,660,0,660,,,
5513351000,730,0,730,,,
5513351000,874,0,874,,,
5513351000,926,0,926,,,
5513351000,928,0,928,,,
5513351000,965,0,965,,,
5513351000,984,0,984,,,
5513351000,1030,0,1030,,,
5513351000,1072,0,1072,,,
5513351000,1108,0,1108,,,
5513351000,1171,0,1171,,,
5513351000,1262,0,1262,,,
5513351000,1350,0,1350,,,
5513351000,1357,0,1357,,,
5513351000,1381,0,1381,,,
5513351000,1390,0,1390,,,
5513351000,1398,0,1398,,,
5513351000,1415,0,1415,,,
5513351000,1544,0,1544,,,
5513351000,1603,0,1603,,,
5513351000,1632,0,1632,,,
5513351375,3,0,3,,,
5513351375,2274,0,2274,,,
5513351400,2105,0,2105,,,
5513351400,4247,0,4247,,,
5513353000,0,0,0,,,
5513355050,4991,0,4991,,,
5513355075,1742,0,1742,,,
5513355075,3854,0,3854,,,
5513355275,2247,0,2247,,,
5513355275,2376,0,2376,,,
5513355275,2462,0,2462,,,
5513355275,2571,0,2571,,,
5513355275,2606,0,2606,,,
5513355275,2698,0,2698,,,
5513355275,2824,0,2824,,,
5513355550,1052,0,1052,,,
5513356375,5,0,5,,,
5513356375,146,0,146,,,
5513356375,193,0,193,,,
5513356375,209,0,209,,,
5513356375,223,0,223,,,
5513356375,253,0,253,,,
5513356375,324,0,324,,,
5513356375,431,0,431,,,
5513356375,519,0,519,,,
5513356375,660,0,660,,,
5513356375,902,0,902,,,
5513356375,1094,0,1094,,,
5513356375,1121,0,1121,,,
5513356375,1302,0,1302,,,
5513356375,1322,0,1322,,,
5513356375,1420,0,1420,,,
5513356375,1474,0,1474,,,
5513356375,1516,0,1516,,,
5513356375,1533,0,1533,,,
5513356375,1553,0,1553,,,
5513356375,1711,0,1711,,,
5513356375,1897,0,1897,,,
5513356375,1920,0,1920,,,
5513356375,1963,0,1963,,,
5513356375,2015,0,2015,,,
5513356375,2042,0,2042,,,
5513356375,2229,0,2229,,,
5513358400,1586,0,1586,,,
5513359250,2659,0,2659,,,
5513359250,2718,0,2718,,,
5513359250,2952,0,2952,,,
5513359250,3079,0,3079,,,
5513359275,26,0,26,,,
5513359275,2005,0,2005,,,
5513359275,2093,0,2093,,,
5513359275,2449,0,2449,,,
5513359300,455,0,455,,,
5513360700,2891,0,2891,,,
5513362240,3416,0,3416,,,
5513362240,3616,0,3616,,,
5513362240,3981,0,3981,,,
5513362250,2401,0,2401,,,
5513362250,2966,0,2966,,,
5513378375,1158,0,1158,,,
5513378375,2313,0,2313,,,
5513378750,1162,0,1162,,,
5513378750,1654,0,1654,,,
5513378750,2074,0,2074,,,
5513378750,2259,0,2259,,,
5513382575,2005,0,2005,,,
5513382575,2463,0,2463,,,
5513383175,1983,0,1983,,,
5513384250,0,0,0,,,
5513384250,0,0,0,,,
5513384250,0,0,0,,,
5513384250,0,0,0,,,
5513384250,0,0,0,,,
5513384250,0,0,0,,,
5513384250,0,0,0,,,
5513384250,0,0,0,,,
5513384250,0,0,0,,,
5513384250,59,0,59,,,
5513384250,257,0,257,,,
5513384250,419,0,419,,,
5513384250,450,0,450,,,
5513384250,522,0,522,,,
5513384250,550,0,550,,,
5513384250,591,0,591,,,
5513384250,600,0,600,,,
5513384250,672,0,672,,,
5513384250,739,0,739,,,
5513384250,745,0,745,,,
5513384250,842,0,842,,,
5513384250,866,0,866,,,
5513384250,976,0,976,,,
5513384250,1046,0,1046,,,
5513384250,1173,0,1173,,,
5513384250,1179,0,1179,,,
5513384250,1179,0,1179,,,
5513384250,1191,0,1191,,,
5513384250,1225,0,1225,,,
5513384250,1272,0,1272,,,
5513384250,1296,0,1296,,,
5513384250,1366,0,1366,,,
5513384250,1370,0,1370,,,
5513384250,1384,0,1384,,,
5513384250,1465,0,1465,,,
5513384250,1467,0,1467,,,
5513384250,1467,0,1467,,,
5513384250,1472,0,1472,,,
5513384250,1557,0,1557,,,
5513384250,1624,0,1624,,,
5513384250,1628,0,1628,,,
5513384250,1706,0,1706,,,
5513384250,1878,0,1878,,,
5513384250,1924,0,1924,,,
5513384250,1982,0,1982,,,
5513384250,2047,0,2047,,,
5513384250,2455,0,2455,,,
5513384275,6,0,6,,,
5513384275,1090,0,1090,,,
5513384275,2482,0,2482,,,
5513384275,3065,0,3065,,,
5513505625,476,0,476,,,
5513507250,56,0,56,,,
5513512000,1151,0,1151,,,
5513515725,2390,0,2390,,,
5513519025,1889,0,1889,,,
5513521200,439,0,439,,,
5513523850,173,0,173,,,
5513525400,2555,0,2555,,,
5513527800,498,0,498,,,
5513527850,453,0,453,,,
5513532925,291,0,291,,,
5513533850,407,0,407,,,
5513537025,746,0,746,,,
5513537050,637,0,637,,,
5513542650,793,0,793,,,
5513543075,1045,0,1045,,,
5513544575,965,0,965,,,
5513545300,846,0,846,,,
5513548350,723,0,723,,,
5513549400,617,0,617,,,
5513549975,589,0,589,,,
5513555025,666,0,666,,,
5513555025,1204,0,1204,,,
5513556925,625,0,625,,,
5513556925,711,0,711,,,
5513556925,791,0,791,,,
5513556925,864,0,864,,,
5513559475,90,0,90,,,
5513569900,887,0,887,,,
5513570900,427,0,427,,,
5513571975,227,0,227,,,
5513572000,751,0,751,,,
5513581700,478,0,478,,,
5513584375,3407,0,3407,,,
5513584400,767,0,767,,,
5513586400,931,0,931,,,
5513586425,363,0,363,,,
5513589375,199,0,199,,,
5513703925,616,0,616,,,
5513706925,53,0,53,,,
5513708300,622,0,622,,,
5513716375,255,0,255,,,
5513716400,444,0,444,,,
5513718475,615,0,615,,,
5513719300,492,0,492,,,
5513732450,244,0,244,,,
5513732475,330,0,330,,,
5513743500,981,0,981,,,
5513745425,255,0,255,,,
5513749425,1365,0,1365,,,
5513754825,831,0,831,,,
5513759225,266,0,266,,,
5513763150,426,0,426,,,
5513763175,301,0,301,,,
5513764975,964,0,964,,,
5513766625,537,0,537,,,
5513767550,269,0,269,,,
5513769425,409,0,409,,,
5513771825,697,0,697,,,
5513776400,959,0,959,,,
5513783425,379,0,379,,,
5513784625,947,0,947,,,
5513784650,885,0,885,,,
5513787075,422,0,422,,,
5513901025,2526,0,2526,,,
5513901025,2533,0,2533,,,
5513902375,133,0,133,,,
5513902375,468,0,468,,,
5513908000,1859,0,1859,,,
5513915150,2795,0,2795,,,
5513950825,0,0,0,,,
5513950825,0,0,0,,,
5513950825,1179,0,1179,,,
5513950825,2391,0,2391,,,
5513950825,2485,0,2485,,,
5513950825,2639,0,2639,,,
5513950850,2110,0,2110,,,
5513950850,2197,0,2197,,,
5513950850,3221,0,3221,,,
5513950850,3968,0,3968,,,
5513955750,2178,0,2178,,,
5513955750,2449,0,2449,,,
5513955750,2688,0,2688,,,
5513955750,2777,0,2777,,,
5513955750,3009,0,3009,,,
5513955750,3281,0,3281,,,
5513955775,2480,0,2480,,,
5513955850,1027,0,1027,,,
5513956100,488,0,488,,,
5513959875,2084,0,2084,,,
5513959900,1400,0,1400,,,
5513960500,0,0,0,,,
5513960500,0,0,0,,,
5513960500,0,0,0,,,
5513960500,0,0,0,,,
5513960500,2,0,2,,,
5513960500,2,0,2,,,
5513960500,3,0,3,,,
5513960500,38,0,38,,,
5513960500,100,0,100,,,
5513960500,106,0,106,,,
5513960500,284,0,284,,,
5513960500,312,0,312,,,
5513960500,548,0,548,,,
5513960500,561,0,561,,,
5513960500,561,0,561,,,
5513960500,846,0,846,,,
5513960500,935,0,935,,,
5513960500,1133,0,1133,,,
5513960500,1164,0,1164,,,
5513960500,1240,0,1240,,,
5513960500,1247,0,1247,,,
5513960500,1265,0,1265,,,
5513960500,1297,0,1297,,,
5513960500,1316,0,1316,,,
5513960500,1330,0,1330,,,
5513960500,1382,0,1382,,,
5513960500,1433,0,1433,,,
5513960500,1440,0,1440,,,
5513960500,1440,0,1440,,,
5513960500,1506,0,1506,,,
5513960500,1516,0,1516,,,
5513960500,1533,0,1533,,,
5513960500,1540,0,1540,,,
5513960500,1545,0,1545,,,
5513960500,1551,0,1551,,,
5513960500,1561,0,1561,,,
5513960500,1571,0,1571,,,
5513960500,1611,0,1611,,,
5513960500,1690,0,1690,,,
5513960500,1763,0,1763,,,
5513960500,2039,0,2039,,,
5513960500,2237,0,2237,,,
5513960525,50,0,50,,,
5513960525,1808,0,1808,,,
5513964875,868,0,868,,,
5513970125,1017,0,1017,,,
5513982175,1020,0,1020,,,
5513982875,3,0,3,,,
5513982875,1345,0,1345,,,
5513987650,1268,0,1268,,,
5513987900,1687,0,1687,,,
5513987925,8,0,8,,,
5513987925,1813,0,1813,,,
5513988475,267,0,267,,,
5513988475,592,0,592,,,
5514103025,181,0,181,,,
5514103050,520,0,520,,,
5514103775,427,0,427,,,
5514103800,492,0,492,,,
5514107650,531,0,531,,,
5514112275,333,0,333,,,
5514112775,281,0,281,,,
5514117525,125,0,125,,,
5514120075,228,0,228,,,
5514130125,5340,0,5340,,,
5514132575,449,0,449,,,
5514134250,535,0,535,,,
5514134675,127,0,127,,,
5514144550,1096,0,1096,,,
5514149675,785,0,785,,,
5514149675,823,0,823,,,
5514149675,950,0,950,,,
5514149675,951,0,951,,,
5514149675,1038,0,1038,,,
5514149675,1072,0,1072,,,
5514149675,1238,0,1238,,,
5514149675,1259,0,1259,,,
5514149675,1270,0,1270,,,
5514149675,1395,0,1395,,,
5514149700,518,0,518,,,
5514151875,169,0,169,,,
5514151900,400,0,400,,,
5514155875,1350,0,1350,,,
5514163100,548,0,548,,,
5514164175,1157,0,1157,,,
5514164200,813,0,813,,,
5514167000,247,0,247,,,
5514167500,962,0,962,,,
5514168625,550,0,550,,,
5514170000,287,0,287,,,
5514170025,712,0,712,,,
5514171600,3200,0,3200,,,
5514172575,710,0,710,,,
5514173475,506,0,506,,,
5514173900,648,0,648,,,
5514182650,335,0,335,,,
5514188200,2746,0,2746,,,
5514188200,3137,0,3137,,,
5514188200,4525,0,4525,,,
5514188575,528,0,528,,,
5600100000,17402,,17402,,,
5600300000,5870,,5870,,,
5600500000,18403,,18403,,,
5600700000,6981,,6981,,,
5600900000,6653,,6653,,,
5601100000,4139,,4139,,,
5601300000,17940,,17940,,,
5601500000,6159,,6159,,,
5601700000,2841,,2841,,,
5601900000,4686,,4686,,,
5602100000,41535,,41535,,,
5602300000,9236,,9236,,,
5602500000,33675,,33675,,,
5602700000,1444,,1444,,,
5602900000,15579,,15579,,,
5603100000,4871,,4871,,,
5603300000,15159,,15159,,,
5603500000,4719,,4719,,,
5603700000,17595,,17595,,,
5603900000,12864,,12864,,,
5604100000,9280,,9280,,,
5604300000,4280,,4280,,,
5604500000,3619,,3619,,,
6000000000,16776,,16776,,,
6600000000,51975,,51975,,,
7800000000,51326,,51326,51326,102652,153978